Usuario,IDs auditados,Total errores,Error LEVE,Error GRAVE,% error,% de efectividad,Week
ext_gutifran,199,1,0,1,"0,50%","0,9949748744",1
ext_jotrimar,161,20,11,9,"12,42%","0,8757763975",1
ext_namangas,159,60,15,45,"37,74%","0,6226415094",1
ext_fagaglia,144,20,4,16,"13,89%","86,11%",1
ext_canatura,143,33,15,18,"23,08%","0,7692307692",1
ext_mapeppe,120,15,12,3,"12,50%","0,875",1
ext_martga,107,23,10,13,"21,50%","0,785046729",1
ext_joavgust,99,17,0,17,"17,17%","0,8365384615",1
ext_joastori,94,11,3,8,"11,70%","0,8829787234",1
ext_masolvey,93,39,2,37,"41,94%","0,5806451613",1
ext_mibrizue,74,5,1,4,"6,76%","93,24%",1
ext_igpachec,68,29,17,12,"42,65%","0,5735294118",1
ext_ola,55,15,10,5,"27,27%","72,73%",1
ext_sancjoaq,34,0,0,0,"0,00%",1,1
ext_mibrizue,127,3,1,2,"2,36%","97,53%",2
ext_igjerez,122,1,0,1,"0,82%","0,9918032787",2
ext_jotrimar,115,5,3,2,"4,35%","0,9565217391",2
ext_fagaglia,100,3,2,1,"3,00%","97,00%",2
ext_masolvey,82,10,7,3,"12,20%","0,8780487805",2
ext_agnovare,64,2,2,0,"3,13%","0,96875",2
ext_lopmatia,58,7,0,7,"12,07%","0,8793103448",2
ext_matiam,53,3,2,1,"5,66%","94,34%",2
ext_ola,45,2,0,2,"4,44%","95,56%",2
ext_maabrigo,39,0,0,0,"0,00%",1,2
ext_aiolmedo,33,1,0,1,"3,03%","96,97%",2
ext_nadsosa,30,4,1,3,"13,33%","0,8666666667",2
ext_jodragon,25,0,0,0,"0,00%",1,2
ext_canatura,227,56,9,47,"24,67%","0,7533039648",3
ext_masolvey,162,38,20,18,"23,46%","0,81",3
ext_mibrizue,155,10,3,7,"6,45%","94,05%",3
ext_sancjoaq,140,40,37,3,"28,57%","0,7142857143",3
ext_igjerez,130,11,3,8,"8,46%","0,9097744361",3
ext_joavgust,129,4,0,4,"3,10%","0,9689922481",3
ext_fagaglia,120,2,1,1,"1,67%","98,45%",3
ext_agnovare,119,0,0,0,"0,00%",1,3
ext_lopmatia,100,5,5,0,"5,00%","0,95",3
ext_martga,64,13,3,10,"20,31%","0,816091954",3
ext_canatura,127,22,0,22,"17,32%","0,8267716535",4
ext_namangas,109,25,0,25,"22,94%","0,7706422018",4
ext_joavgust,96,0,0,0,"0,00%",1,4
ext_masolvey,92,18,17,1,"19,57%","0,8043478261",4
ext_martga,91,9,0,9,"9,89%","0,9010989011",4
ext_mibrizue,90,6,3,3,"6,67%","93,33%",4
ext_gutifran,80,3,1,2,"3,75%","0,9625",4
ext_fagaglia,70,3,0,3,"4,29%","95,71%",4
ext_lopmatia,62,6,2,4,"9,68%","0,9032258065",4
ext_igjerez,48,2,0,2,"4,17%","0,9583333333",4
ext_jotrimar,44,0,0,0,"0,00%",1,4
ext_ola,37,0,0,0,"0,00%","100,00%",4
ext_joastori,32,0,0,0,"0,00%",1,4
ext_jodragon,29,2,0,2,"6,90%","0,9310344828",4
ext_nadsosa,24,0,0,0,"0,00%",1,4
ext_sancjoaq,15,0,0,0,"0,00%",1,4
ext_tibareir,291,3,0,3,"1,03%","0,9896907216",5
ext_igjerez,229,30,17,13,"13,10%","0,8689956332",5
ext_namangas,225,43,17,26,"19,11%","0,8088888889",5
ext_martga,179,52,25,27,"29,05%","0,7127071823",5
ext_sancjoaq,166,53,1,52,"31,93%","0,6807228916",5
ext_gutifran,149,0,0,0,"0,00%",1,5
ext_agnovare,131,0,0,0,"0,00%",1,5
ext_joastori,126,29,10,19,"23,02%","0,7698412698",5
ext_masolvey,116,4,4,0,"3,45%","0,9655172414",5
ext_canatura,97,8,7,1,"8,25%","0,9175257732",5
ext_jotrimar,97,1,0,1,"1,03%","0,9896907216",5
ext_joavgust,92,19,9,10,"20,65%","0,7934782609",5
ext_mibrizue,87,21,14,7,"24,14%","77,42%",5
ext_ola,86,17,0,17,"19,77%","80,23%",5
ext_matiam,65,1,0,1,"1,54%","98,46%",5
ext_nadsosa,35,9,0,9,"25,71%","0,7428571429",5
ext_aiolmedo,27,4,0,4,"14,81%","85,19%",5
ext_jodragon,26,0,0,0,"0,00%",1,5
ext_jotrimar,211,8,0,8,"3,79%","0,9620853081",6
ext_fagaglia,198,14,0,14,"7,07%","93,20%",6
ext_masolvey,139,12,5,7,"8,63%","0,9136690647",6
ext_magrodon,121,24,3,21,"19,83%","0,8016528926",6
ext_igjerez,112,13,0,13,"11,61%","0,9029850746",6
ext_canatura,110,14,3,11,"12,73%","0,9020979021",6
ext_gutifran,108,17,0,17,"15,74%","0,8425925926",6
ext_nadsosa,106,0,0,0,"0,00%",1,6
ext_matiam,104,28,3,25,"26,92%","73,08%",6
ext_agnovare,92,17,14,3,"18,48%","0,8152173913",6
ext_aiolmedo,90,19,19,0,"21,11%","81,00%",6
ext_facacuna,90,2,0,2,"2,22%","97,78%",6
ext_namangas,86,6,0,6,"6,98%","0,9302325581",6
ext_ola,81,11,2,9,"13,58%","88,00%",6
ext_tovulcan,80,14,2,12,"17,50%","0,825",6
ext_mibrizue,79,3,3,0,"3,80%","96,20%",6
ext_jodragon,64,1,0,1,"1,56%","0,984375",6
ext_joastori,53,2,0,2,"3,77%","0,9622641509",6
ext_sancjoaq,50,7,4,3,"14,00%","0,86",6
ext_martga,45,20,3,17,"44,44%","0,5531914894",6
ext_juawagne,39,1,0,1,"2,56%","0,9743589744",6
ext_jocambar,37,29,4,25,"78,38%","0,2162162162",6
ext_joavgust,30,4,0,4,"13,33%","0,8666666667",6
ext_tibareir,3,0,0,0,"0,00%",1,6
ext_ola,294,9,1,8,"3,06%","96,94%",7
ext_facacuna,177,8,0,8,"4,52%","95,48%",7
ext_canatura,148,14,2,12,"9,46%","0,9054054054",7
ext_juawagne,138,35,27,8,"25,36%","0,7635135135",7
ext_jocambar,132,22,1,21,"16,67%","0,8571428571",7
ext_namangas,90,2,0,2,"2,22%","0,9777777778",7
ext_fagaglia,89,5,3,2,"5,62%","94,38%",7
ext_tovulcan,80,14,13,1,"17,50%","0,825",7
ext_mibrizue,74,32,30,2,"43,24%","56,76%",7
ext_nadsosa,67,23,23,0,"34,33%","0,6567164179",7
ext_joavgust,60,5,0,5,"8,33%","0,9166666667",7
ext_jodragon,56,8,3,5,"14,29%","0,8571428571",7
ext_magrodon,51,1,1,0,"1,96%","0,9803921569",7
ext_jotrimar,46,0,0,0,"0,00%",1,7
ext_matiam,31,3,0,3,"9,68%","90,32%",7
ext_gutifran,23,0,0,0,"0,00%",1,7
ext_masolvey,20,0,0,0,"0,00%",1,7
ext_aiolmedo,6,0,0,0,"0,00%","100,00%",7
ext_igjerez,6,0,0,0,"0,00%",1,7
ext_canatura,119,19,1,18,"15,97%","0,8403361345",8
ext_fagaglia,114,9,8,1,"7,89%","92,17%",8
ext_aiolmedo,69,1,0,1,"1,45%","98,55%",8
ext_gutifran,64,12,5,7,"18,75%","0,8125",8
ext_igjerez,62,0,0,0,"0,00%",1,8
ext_jodragon,50,1,0,1,"2,00%","0,98",8
ext_jocambar,50,3,1,2,"6,00%","0,94",8
ext_namangas,50,7,1,6,"14,00%","0,86",8
ext_ola,44,11,3,8,"25,00%","75,00%",8
ext_joavgust,44,18,6,12,"40,91%","0,5909090909",8
ext_tovulcan,41,6,0,6,"14,63%","0,8536585366",8
ext_facacuna,41,9,2,7,"21,95%","78,05%",8
ext_masolvey,40,1,0,1,"2,50%","0,975",8
ext_matiam,29,0,0,0,"0,00%","100,00%",8
ext_magrodon,24,0,0,0,"0,00%",1,8
ext_mibrizue,15,6,6,0,"40,00%","60,00%",8
ext_nadsosa,13,2,0,2,"15,38%","0,8461538462",8
ext_agnovare,4,1,1,0,"25,00%","0,6",8
ext_masolvey,357,34,5,29,"9,52%","0,9047619048",9
ext_ola,293,28,9,19,"9,56%","90,44%",9
ext_namangas,94,13,0,13,"13,83%","0,8617021277",9
ext_jocambar,90,7,1,6,"7,78%","0,9222222222",9
ext_igjerez,79,3,0,3,"3,80%","0,9620253165",9
ext_aiolmedo,65,0,0,0,"0,00%","100,00%",9
ext_jodragon,62,3,2,1,"4,84%","0,9516129032",9
ext_nadsosa,52,10,1,9,"19,23%","0,8076923077",9
ext_magrodon,45,5,4,1,"11,11%","0,8888888889",9
ext_agnovare,37,9,7,2,"24,32%","0,7567567568",9
ext_matiam,27,0,0,0,"0,00%","100,00%",9
ext_gutifran,19,1,0,1,"5,26%","0,9473684211",9
ext_fagaglia,13,2,0,2,"15,38%","84,62%",9
ext_juawagne,10,0,0,0,"0,00%",1,9
ext_joavgust,2,1,0,1,"50,00%","0,5",9
ext_jodragon,94,0,0,0,"0,00%",1,10
ext_kevvigil,82,20,8,12,"24,39%","0,756097561",10
ext_facacuna,73,18,4,14,"24,66%","75,34%",10
ext_canatura,67,0,0,0,"0,00%",1,10
ext_toarruss,60,9,0,9,"15,00%","85,00%",10
ext_jocambar,40,14,5,9,"35,00%","0,65",10
ext_namangas,39,0,0,0,"0,00%",1,10
ext_joastori,30,2,0,2,"6,67%","0,9333333333",10
ext_ola,28,12,0,12,"42,86%","57,14%",10
ext_fltangor,24,1,1,0,"4,17%","0,9583333333",10
ext_jotrimar,10,0,0,0,"0,00%",1,10
ext_masolvey,8,0,0,0,"0,00%",1,10
ext_mibrizue,7,0,0,0,"0,00%","100,00%",10
ext_jocambar,216,13,2,11,"6,02%","0,9398148148",11
ext_kevvigil,169,55,53,2,"32,54%","0,674556213",11
ext_toarruss,129,32,16,16,"24,81%","75,19%",11
ext_fltangor,120,11,1,10,"9,17%","0,9083333333",11
ext_jodragon,77,1,0,1,"1,30%","0,987012987",11
ext_nadsosa,70,0,0,0,"0,00%",1,11
ext_masolvey,34,4,2,2,"11,76%","0,8823529412",11
ext_gutifran,31,0,0,0,"0,00%",1,11
ext_fagaglia,30,0,0,0,"0,00%","100,00%",11
ext_ola,28,0,0,0,"0,00%","100,00%",11
ext_tovulcan,25,1,0,1,"4,00%","0,96",11
ext_agnovare,23,0,0,0,"0,00%",1,11
ext_aiolmedo,22,0,0,0,"0,00%","100,00%",11
ext_facacuna,20,2,0,2,"10,00%","90,00%",11
ext_matiam,19,0,0,0,"0,00%","100,00%",11
ext_canatura,13,2,1,1,"15,38%","0,8461538462",11
ext_sancjoaq,10,0,0,0,"0,00%",1,11
ext_jotrimar,8,0,0,0,"0,00%",1,11
ext_joastori,4,0,0,0,"0,00%",1,11
ext_juawagne,4,2,2,0,"50,00%","0,5",11
ext_tibareir,4,0,0,0,"0,00%",1,11
ext_igjerez,3,0,0,0,"0,00%",1,11
ext_magrodon,1,0,0,0,"0,00%",1,11
ext_mibrizue,1,0,0,0,"0,00%","100,00%",11
ext_tovulcan,140,37,0,37,"26,43%","0,7357142857",12
ext_kevvigil,114,8,0,8,"7,02%","0,9298245614",12
ext_facacuna,107,33,8,25,"30,84%","69,16%",12
ext_juawagne,68,0,0,0,"0,00%",1,12
ext_canatura,68,29,0,29,"42,65%","0,5735294118",12
ext_toarruss,54,2,1,1,"3,70%","96,30%",12
ext_joavgust,52,0,0,0,"0,00%",1,12
ext_jodragon,51,3,0,3,"5,88%","0,9411764706",12
ext_jocambar,44,11,10,1,"25,00%","0,75",12
ext_masolvey,42,1,0,1,"2,38%","0,9761904762",12
ext_mibrizue,39,5,1,4,"12,82%","87,18%",12
ext_tibareir,28,2,0,2,"7,14%","0,9285714286",12
ext_fltangor,27,3,1,2,"11,11%","0,8888888889",12
ext_magrodon,24,1,1,0,"4,17%","0,9583333333",12
ext_matiam,22,2,0,2,"9,09%","90,91%",12
ext_joastori,20,0,0,0,"0,00%",1,12
ext_ola,17,2,1,1,"11,76%","88,24%",12
ext_nadsosa,14,7,0,7,"50,00%","0,5",12
ext_igjerez,12,2,0,2,"16,67%","0,8333333333",12
ext_aiolmedo,11,0,0,0,"0,00%","100,00%",12
ext_fagaglia,10,2,1,1,"20,00%","80,00%",12
ext_namangas,7,0,0,0,"0,00%",1,12
ext_gutifran,7,1,0,1,"14,29%","0,8571428571",12
ext_jotrimar,4,0,0,0,"0,00%",1,12
ext_kevvigil,368,123,107,16,"33,42%","0,6675675676",13
ext_toarruss,343,97,84,13,"28,28%","69,27%",13
ext_tovulcan,232,65,23,42,"28,02%","0,7167381974",13
ext_facacuna,131,56,4,52,"42,75%","55,80%",13
ext_enheredi,130,17,5,12,"13,08%","0,8692307692",13
ext_fagaglia,109,1,0,1,"0,92%","99,17%",13
ext_matiam,92,2,0,2,"2,17%","98,10%",13
ext_ramiherr,92,16,0,16,"17,39%","71,70%",13
ext_canatura,77,23,7,16,"29,87%","0,7012987013",13
ext_aiolmedo,52,0,0,0,"0,00%","100,00%",13
ext_igjerez,46,4,0,4,"8,70%","0,9130434783",13
ext_jocambar,45,16,16,0,"35,56%","0,6444444444",13
ext_nadsosa,45,0,0,0,"0,00%",1,13
ext_matvalle,28,8,4,4,"28,57%","0,7142857143",13
ext_mibrizue,27,0,0,0,"0,00%","100,00%",13
ext_agnovare,23,0,0,0,"0,00%",1,13
ext_joastori,21,1,0,1,"4,76%","0,9523809524",13
ext_tibareir,20,0,0,0,"0,00%",1,13
ext_ola,16,5,0,5,"31,25%","68,75%",13
ext_fltangor,14,5,2,3,"35,71%","0,6428571429",13
ext_sancjoaq,13,0,0,0,"0,00%",1,13
ext_juawagne,11,6,4,2,"54,55%","0,4545454545",13
ext_namangas,8,4,0,4,"50,00%","0,5",13
ext_joavgust,3,1,1,0,"33,33%","0,6666666667",13
ext_masolvey,1,0,0,0,"0,00%",1,13
ext_tovulcan,245,16,4,12,"6,53%","0,936",14
ext_kevvigil,113,14,3,11,"12,39%","0,8760330579",14
ext_fltangor,109,8,0,8,"7,34%","0,9266055046",14
ext_toarruss,103,14,4,10,"13,59%","86,54%",14
ext_agnovare,93,0,0,0,"0,00%",1,14
ext_enheredi,85,4,2,2,"4,71%","0,9529411765",14
ext_ramiherr,79,7,3,4,"8,86%","90,00%",14
ext_matiam,78,2,0,2,"2,56%","97,44%",14
ext_matvalle,78,17,14,3,"21,79%","0,7820512821",14
ext_juawagne,75,4,1,3,"5,33%","0,9466666667",14
ext_facacuna,74,17,1,16,"22,97%","77,03%",14
ext_canatura,74,6,0,6,"8,11%","0,9189189189",14
ext_joastori,73,0,0,0,"0,00%",1,14
ext_joavgust,58,1,1,0,"1,72%","0,9830508475",14
ext_sancjoaq,51,6,0,6,"11,76%","0,8823529412",14
ext_tibareir,41,1,1,0,"2,44%","0,9791666667",14
ext_mibrizue,34,2,1,1,"5,88%","94,12%",14
ext_fagaglia,33,3,0,3,"9,09%","90,91%",14
ext_igjerez,29,0,0,0,"0,00%",1,14
ext_namangas,20,0,0,0,"0,00%",1,14
ext_jodragon,17,0,0,0,"0,00%",1,14
ext_masolvey,14,1,0,1,"7,14%","0,9285714286",14
ext_aiolmedo,13,0,0,0,"0,00%","100,00%",14
ext_jocambar,12,0,0,0,"0,00%",1,14
ext_jotrimar,10,0,0,0,"0,00%",1,14
ext_ola,9,0,0,0,"0,00%","100,00%",14
ext_nadsosa,7,2,0,2,"28,57%","0,7142857143",14
ext_kevvigil,208,32,25,7,"15,38%","0,8476190476",15
ext_jocambar,157,14,6,8,"8,92%","0,9141104294",15
ext_ola,136,11,5,6,"8,09%","91,91%",15
ext_mibrizue,109,15,13,2,"13,76%","87,39%",15
ext_toarruss,103,10,5,5,"9,71%","90,48%",15
ext_joastori,101,2,0,2,"1,98%","0,9814814815",15
ext_jodragon,82,0,0,0,"0,00%",1,15
ext_juawagne,67,5,2,3,"7,46%","0,8985507246",15
ext_masolvey,62,0,0,0,"0,00%",1,15
ext_matvalle,56,1,1,0,"1,79%","0,9821428571",15
ext_joavgust,48,4,4,0,"8,33%","0,9473684211",15
ext_namangas,38,1,0,1,"2,63%","0,9736842105",15
ext_fagaglia,38,0,0,0,"0,00%","100,00%",15
ext_tibareir,32,0,0,0,"0,00%",1,15
ext_tovulcan,30,13,13,0,"43,33%","0,5666666667",15
ext_agnovare,30,0,0,0,"0,00%",1,15
ext_sancjoaq,29,6,3,3,"20,69%","0,7931034483",15
ext_fltangor,24,2,2,0,"8,33%","0,9166666667",15
ext_facacuna,24,11,2,9,"45,83%","54,17%",15
ext_ramiherr,23,0,0,0,"0,00%","100,00%",15
ext_jotrimar,22,0,0,0,"0,00%",1,15
ext_matiam,22,1,1,0,"4,55%","95,45%",15
ext_enheredi,21,1,1,0,"4,76%","0,9523809524",15
ext_aiolmedo,3,0,0,0,"0,00%","100,00%",15
ext_nadsosa,2,0,0,0,"0,00%",1,15
ext_matiam,157,1,0,1,"0,64%","99,38%",16
ext_fagaglia,102,6,2,4,"5,88%","93,27%",16
ext_kevvigil,86,3,0,3,"3,49%","0,9651162791",16
ext_tovulcan,68,27,11,16,"39,71%","0,6197183099",16
ext_toarruss,63,12,2,10,"19,05%","80,95%",16
ext_igjerez,54,0,0,0,"0,00%",1,16
ext_jocambar,53,3,1,2,"5,66%","0,9433962264",16
ext_ramiherr,52,5,0,5,"9,62%","90,38%",16
ext_mibrizue,48,2,0,2,"4,17%","95,83%",16
ext_enheredi,37,14,0,14,"37,84%","0,6216216216",16
ext_joavgust,26,1,0,1,"3,85%","0,9259259259",16
ext_facacuna,25,12,1,11,"48,00%","53,57%",16
ext_agnovare,15,0,0,0,"0,00%",1,16
ext_matvalle,15,0,0,0,"0,00%",1,16
ext_aiolmedo,15,0,0,0,"0,00%","100,00%",16
ext_ola,12,0,0,0,"0,00%","100,00%",16
ext_namangas,12,2,0,2,"16,67%","0,8333333333",16
ext_sancjoaq,11,7,0,7,"63,64%","0,3076923077",16
ext_facacuna,145,18,13,5,"12,41%","88,89%",17
ext_toarruss,94,6,6,0,"6,38%","93,62%",17
ext_masolvey,92,1,0,1,"1,09%","0,9891304348",17
ext_fltangor,77,12,3,9,"15,58%","0,8441558442",17
ext_juawagne,73,29,22,7,"39,73%","0,5357142857",17
ext_jocambar,70,3,1,2,"4,29%","0,9577464789",17
ext_nadsosa,66,2,1,1,"3,03%","0,9696969697",17
ext_tovulcan,62,4,0,4,"6,45%","0,935483871",17
ext_fagaglia,62,0,0,0,"0,00%","100,00%",17
ext_joavgust,43,2,2,0,"4,65%","0,9545454545",17
ext_ola,41,9,3,6,"21,95%","78,57%",17
ext_kevvigil,32,0,0,0,"0,00%",1,17
ext_matvalle,32,4,3,1,"12,50%","0,875",17
ext_matiam,26,3,1,2,"11,54%","88,46%",17
ext_enheredi,24,0,0,0,"0,00%",1,17
ext_ramiherr,24,0,0,0,"0,00%","100,00%",17
ext_sancjoaq,18,1,0,1,"5,56%","0,9444444444",17
ext_mibrizue,17,3,0,3,"17,65%","82,35%",17
ext_igjerez,14,0,0,0,"0,00%",1,17
ext_agnovare,14,0,0,0,"0,00%",1,17
ext_joastori,11,3,0,3,"27,27%","0,7272727273",17
ext_jotrimar,6,1,0,1,"16,67%","0,8333333333",17
ext_namangas,4,0,0,0,"0,00%",1,17
ext_aiolmedo,3,0,0,0,"0,00%","100,00%",17
ext_jodragon,1,0,0,0,"0,00%",1,17
ext_enheredi,192,29,6,23,"15,10%","0,8489583333",18
ext_tovulcan,100,11,7,4,"11,00%","0,8640776699",18
ext_toarruss,91,5,2,3,"5,49%","94,51%",18
ext_sancjoaq,80,8,2,6,"10,00%","0,9036144578",18
ext_facacuna,70,15,3,12,"21,43%","77,46%",18
ext_tibareir,51,8,5,3,"15,69%","0,8596491228",18
ext_ensole,43,24,12,12,"55,81%","0,4897959184",18
ext_joastori,43,0,0,0,"0,00%",1,18
ext_igcuevas,42,10,1,9,"23,81%","78,72%",18
ext_jocambar,40,11,2,9,"27,50%","0,725",18
ext_matiam,39,0,0,0,"0,00%","100,00%",18
ext_masolvey,34,0,0,0,"0,00%",1,18
ext_agnovare,30,0,0,0,"0,00%",1,18
ext_juawagne,28,3,1,2,"10,71%","0,8333333333",18
ext_aiolmedo,23,0,0,0,"0,00%","100,00%",18
ext_mibrizue,23,1,0,1,"4,35%","95,65%",18
ext_fagaglia,19,6,0,6,"31,58%","68,42%",18
ext_ola,19,0,0,0,"0,00%","100,00%",18
ext_kevvigil,19,8,0,8,"42,11%","0,5789473684",18
ext_namangas,17,0,0,0,"0,00%",1,18
ext_matvalle,15,7,0,7,"46,67%","0,5333333333",18
ext_joavgust,13,2,0,2,"15,38%","0,8461538462",18
ext_ramiherr,11,3,0,3,"27,27%","72,73%",18
ext_fltangor,5,2,0,2,"40,00%","0,6",18
ext_nadsosa,5,0,0,0,"0,00%",1,18
ext_jodragon,2,0,0,0,"0,00%",1,18
ext_fltangor,157,41,20,21,"26,11%","0,7388535032",19
ext_juawagne,156,2,1,1,"1,28%","0,9901960784",19
ext_igcuevas,143,19,5,14,"13,29%","86,71%",19
ext_nadsosa,104,0,0,0,"0,00%",1,19
ext_jocambar,87,7,4,3,"8,05%","0,9195402299",19
ext_tovulcan,76,5,2,3,"6,58%","0,9240506329",19
ext_tibareir,65,2,0,2,"3,08%","0,9726027397",19
ext_ensole,62,4,3,1,"6,45%","0,9384615385",19
ext_matvalle,47,22,22,0,"46,81%","0,5319148936",19
ext_joastori,32,1,1,0,"3,13%","0,9705882353",19
ext_aiolmedo,31,0,0,0,"0,00%","100,00%",19
ext_agnovare,23,0,0,0,"0,00%",1,19
ext_facacuna,22,0,0,0,"0,00%","100,00%",19
ext_jotrimar,20,3,0,3,"15,00%","0,85",19
ext_enheredi,18,3,0,3,"16,67%","0,8333333333",19
ext_joavgust,9,0,0,0,"0,00%",1,19
ext_igjerez,7,0,0,0,"0,00%",1,19
ext_matiam,7,0,0,0,"0,00%","100,00%",19
ext_masolvey,7,2,2,0,"28,57%","0,6666666667",19
ext_mibrizue,7,0,0,0,"0,00%","100,00%",19
ext_kevvigil,7,2,1,1,"28,57%","0,7142857143",19
ext_sancjoaq,5,0,0,0,"0,00%",1,19
ext_namangas,5,0,0,0,"0,00%",1,19
ext_toarruss,1,0,0,0,"0,00%","100,00%",19
ext_tovulcan,168,10,8,2,"5,95%","0,9473684211",20
ext_facacuna,111,31,11,20,"27,93%","75,19%",20
ext_joastori,89,1,0,1,"1,12%","0,9887640449",20
ext_juawagne,82,16,14,2,"19,51%","0,8117647059",20
ext_matvalle,78,0,0,0,"0,00%",1,20
ext_igcuevas,77,23,17,6,"29,87%","74,16%",20
ext_joavgust,74,2,0,2,"2,70%","0,9736842105",20
ext_mibrizue,74,21,18,3,"28,38%","71,62%",20
ext_toarruss,70,0,0,0,"0,00%","100,00%",20
ext_ensole,66,11,10,1,"16,67%","0,7721518987",20
ext_sancjoaq,61,7,7,0,"11,48%","0,8852459016",20
ext_fltangor,59,31,14,17,"52,54%","0,4745762712",20
ext_namangas,57,8,0,8,"14,04%","0,8666666667",20
ext_agnovare,56,16,8,8,"28,57%","0,7142857143",20
ext_ola,55,8,2,6,"14,55%","85,45%",20
ext_nadsosa,38,14,14,0,"36,84%","0,6315789474",20
ext_enheredi,37,0,0,0,"0,00%",1,20
ext_jocambar,27,0,0,0,"0,00%",1,20
ext_igjerez,25,0,0,0,"0,00%",1,20
ext_aiolmedo,20,0,0,0,"0,00%","100,00%",20
ext_masolvey,19,0,0,0,"0,00%",1,20
ext_jodragon,17,0,0,0,"0,00%",1,20
ext_matiam,16,1,0,1,"6,25%","94,74%",20
ext_kevvigil,13,1,0,1,"7,69%","0,875",20
ext_fagaglia,12,2,0,2,"16,67%","83,33%",20
ext_jotrimar,9,1,0,1,"11,11%","0,8888888889",20
ext_ramiherr,6,0,0,0,"0,00%","100,00%",20
ext_ensole,126,12,4,8,"9,52%","0,9047619048",21
ext_tibareir,107,5,2,3,"4,67%","0,953271028",21
ext_juawagne,101,21,5,16,"20,79%","0,7692307692",21
ext_kevvigil,99,11,2,9,"11,11%","0,8823529412",21
ext_facacuna,91,33,20,13,"36,26%","64,89%",21
ext_mibrizue,90,7,4,3,"7,78%","92,47%",21
ext_matiam,88,9,5,4,"10,23%","89,77%",21
ext_toarruss,85,17,10,7,"20,00%","80,00%",21
ext_jotrimar,84,2,0,2,"2,38%","0,9764705882",21
ext_masolvey,81,2,0,2,"2,47%","0,9761904762",21
ext_enheredi,77,2,2,0,"2,60%","0,974025974",21
ext_agnovare,72,0,0,0,"0,00%",1,21
ext_sancjoaq,67,3,2,1,"4,48%","0,9558823529",21
ext_fltangor,67,25,17,8,"37,31%","0,6268656716",21
ext_matvalle,65,3,0,3,"4,62%","0,9538461538",21
ext_tovulcan,56,14,12,2,"25,00%","0,7419354839",21
ext_joastori,55,6,1,5,"10,91%","0,8909090909",21
ext_jocambar,53,18,1,17,"33,96%","0,6603773585",21
ext_namangas,40,0,0,0,"0,00%",1,21
ext_igcuevas,33,16,8,8,"48,48%","51,52%",21
ext_igjerez,21,2,1,1,"9,52%","0,9047619048",21
ext_aiolmedo,19,0,0,0,"0,00%","100,00%",21
ext_joavgust,11,0,0,0,"0,00%",1,21
ext_nadsosa,8,4,2,2,"50,00%","0,5",21
ext_fagaglia,7,2,0,2,"28,57%","71,43%",21
ext_ramiherr,4,2,1,1,"50,00%","50,00%",21
ext_ola,3,1,0,1,"33,33%","66,67%",21
ext_jodragon,2,0,0,0,"0,00%",1,21
ext_sancjoaq,146,7,5,2,"4,79%","0,954248366",22
ext_juawagne,138,21,15,6,"15,22%","0,8417266187",22
ext_kevvigil,125,17,12,5,"13,60%","0,8538461538",22
ext_toarruss,111,6,1,5,"5,41%","94,59%",22
ext_joastori,106,38,29,9,"35,85%","0,6465517241",22
ext_dadi,101,6,2,4,"5,94%","94,12%",22
ext_facacuna,98,11,4,7,"11,22%","88,78%",22
ext_jocambar,97,2,0,2,"2,06%","0,9805825243",22
ext_matiam,90,1,0,1,"1,11%","98,89%",22
ext_joavgust,85,24,3,21,"28,24%","0,7894736842",22
ext_tibareir,67,4,1,3,"5,97%","0,9411764706",22
ext_igjerez,56,1,1,0,"1,79%","0,9821428571",22
ext_namangas,53,2,1,1,"3,77%","0,9649122807",22
ext_aiolmedo,48,0,0,0,"0,00%","100,00%",22
ext_igcuevas,48,7,3,4,"14,58%","81,13%",22
ext_fltangor,43,4,2,2,"9,30%","0,9090909091",22
ext_jotrimar,41,0,0,0,"0,00%",1,22
ext_tovulcan,40,9,4,5,"22,50%","0,7906976744",22
ext_mibrizue,32,3,2,1,"9,38%","88,24%",22
ext_agnovare,26,11,0,11,"42,31%","0,4594594595",22
ext_ensole,26,1,1,0,"3,85%","0,9615384615",22
ext_matvalle,19,0,0,0,"0,00%",1,22
ext_nadsosa,10,0,0,0,"0,00%",1,22
ext_masolvey,9,2,0,2,"22,22%","0,7777777778",22
ext_mibrizue,41,4,0,4,"9,76%","90,24%",23
ext_fagaglia,40,5,2,3,"12,50%","87,50%",23
ext_agnovare,39,3,3,0,"7,69%","0,9230769231",23
ext_juawagne,38,1,1,0,"2,63%","0,9736842105",23
ext_masolvey,38,0,0,0,"0,00%",1,23
ext_joavgust,38,5,3,2,"13,16%","0,8837209302",23
ext_sancjoaq,38,5,0,5,"13,16%","0,8684210526",23
ext_jotrimar,38,2,1,1,"5,26%","0,9473684211",23
ext_ramiherr,38,1,0,1,"2,63%","97,37%",23
ext_igjerez,37,0,0,0,"0,00%",1,23
ext_ensole,37,4,1,3,"10,81%","0,9024390244",23
ext_toarruss,37,2,2,0,"5,41%","94,59%",23
ext_facacuna,37,1,0,1,"2,70%","97,30%",23
ext_kevvigil,37,3,1,2,"8,11%","0,925",23
ext_matiam,37,3,1,2,"8,11%","92,31%",23
ext_nadsosa,36,3,0,3,"8,33%","0,9166666667",23
ext_tovulcan,36,2,0,2,"5,56%","0,9534883721",23
ext_dadi,35,5,2,3,"14,29%","82,05%",23
ext_igcuevas,34,3,1,2,"8,82%","91,18%",23
ext_fltangor,33,4,1,3,"12,12%","0,8823529412",23
ext_namangas,31,9,1,8,"29,03%","0,7096774194",23
ext_jocambar,31,2,1,1,"6,45%","0,935483871",23
ext_joastori,30,0,0,0,"0,00%",1,23
ext_tibareir,29,2,0,2,"6,90%","0,9310344828",23
ext_aiolmedo,29,0,0,0,"0,00%","100,00%",23
ext_ola,28,2,1,1,"7,14%","92,86%",23
ext_matvalle,28,3,2,1,"10,71%","0,8928571429",23
ext_fagaglia,82,17,4,13,"20,73%","79,27%",24
ext_igcuevas,80,0,0,0,"0,00%","100,00%",24
ext_facacuna,80,10,0,10,"12,50%","87,50%",24
ext_fltangor,80,18,8,10,"22,50%","0,775",24
ext_ramiherr,80,4,3,1,"5,00%","95,00%",24
ext_jocambar,51,0,0,0,"0,00%",1,24
ext_toarruss,50,1,0,1,"2,00%","96,08%",24
ext_joastori,50,0,0,0,"0,00%",1,24
ext_nadsosa,50,1,0,1,"2,00%","0,98",24
ext_sancjoaq,50,18,4,14,"36,00%","0,64",24
ext_dadi,50,12,0,12,"24,00%","76,00%",24
ext_kevvigil,50,25,3,22,"50,00%","0,5",24
ext_igjerez,50,2,2,0,"4,00%","0,96",24
ext_ola,50,1,0,1,"2,00%","96,67%",24
ext_masolvey,50,0,0,0,"0,00%",1,24
ext_jotrimar,50,1,0,1,"2,00%","0,98",24
ext_matiam,50,4,1,3,"8,00%","92,00%",24
ext_mibrizue,50,0,0,0,"0,00%","100,00%",24
ext_juawagne,50,2,2,0,"4,00%","0,96",24
ext_jodragon,50,0,0,0,"0,00%",1,24
ext_agnovare,50,0,0,0,"0,00%",1,24
ext_tovulcan,50,3,0,3,"6,00%","0,94",24
ext_namangas,50,9,8,1,"18,00%","0,82",24
ext_ensole,50,0,0,0,"0,00%",1,24
ext_matvalle,50,0,0,0,"0,00%",1,24
ext_joavgust,49,0,0,0,"0,00%",1,24
ext_kevvigil,54,0,0,0,"0,00%",1,25
ext_fltangor,54,0,0,0,"0,00%",1,25
ext_namangas,54,0,0,0,"0,00%",1,25
ext_sancjoaq,54,2,0,2,"3,70%","0,962962963",25
ext_fagaglia,54,0,0,0,"0,00%","100,00%",25
ext_matiam,38,0,0,0,"0,00%","100,00%",25
ext_toarruss,38,0,0,0,"0,00%","100,00%",25
ext_agnovare,38,0,0,0,"0,00%",1,25
ext_ensole,38,0,0,0,"0,00%",1,25
ext_mibrizue,38,24,1,23,"63,16%","36,84%",25
ext_jocambar,38,0,0,0,"0,00%",1,25
ext_dadi,38,0,0,0,"0,00%","100,00%",25
ext_joastori,38,8,0,8,"21,05%","0,7894736842",25
ext_facacuna,38,4,0,4,"10,53%","89,47%",25
ext_ramiherr,38,8,2,6,"21,05%","78,95%",25
ext_joavgust,38,1,0,1,"2,63%","0,9487179487",25
ext_nadsosa,38,0,0,0,"0,00%",1,25
ext_igcuevas,38,3,0,3,"7,89%","92,11%",25
ext_ola,38,7,7,0,"18,42%","81,58%",25
ext_jodragon,38,0,0,0,"0,00%",1,25
ext_matvalle,38,0,0,0,"0,00%",1,25
ext_tovulcan,38,1,1,0,"2,63%","0,9736842105",25
ext_juawagne,38,24,3,21,"63,16%","0,3684210526",25
ext_masolvey,38,2,1,1,"5,26%","0,9473684211",25
ext_igjerez,38,0,0,0,"0,00%",1,25
ext_jotrimar,38,0,0,0,"0,00%",1,25
ext_masolvey,24,0,0,0,"0,00%",1,26
ext_aiolmedo,23,0,0,0,"0,00%","100,00%",26
ext_ola,23,0,0,0,"0,00%","100,00%",26
ext_fltangor,23,0,0,0,"0,00%",1,26
ext_joavgust,23,1,0,1,"4,35%","0,9565217391",26
ext_matvalle,23,0,0,0,"0,00%",1,26
ext_ensole,23,0,0,0,"0,00%",1,26
ext_sancjoaq,23,5,0,5,"21,74%","0,7916666667",26
ext_jodragon,23,3,3,0,"13,04%","0,8695652174",26
ext_nadsosa,23,8,2,6,"34,78%","0,652173913",26
ext_tovulcan,23,0,0,0,"0,00%",1,26
ext_igjerez,23,0,0,0,"0,00%",1,26
ext_juawagne,23,0,0,0,"0,00%",1,26
ext_fagaglia,23,0,0,0,"0,00%","100,00%",26
ext_ramiherr,23,0,0,0,"0,00%","100,00%",26
ext_mibrizue,23,0,0,0,"0,00%","100,00%",26
ext_tibareir,23,0,0,0,"0,00%",1,26
ext_jotrimar,23,0,0,0,"0,00%",1,26
ext_matiam,23,0,0,0,"0,00%","100,00%",26
ext_agnovare,23,0,0,0,"0,00%",1,26
ext_facacuna,23,0,0,0,"0,00%","100,00%",26
ext_igcuevas,23,3,0,3,"13,04%","86,96%",26
ext_kevvigil,23,0,0,0,"0,00%",1,26
ext_dadi,23,2,0,2,"8,70%","91,30%",26
ext_toarruss,23,0,0,0,"0,00%","100,00%",26
ext_joastori,23,0,0,0,"0,00%",1,26
ext_jocambar,23,1,0,1,"4,35%","0,9565217391",26
ext_namangas,23,0,0,0,"0,00%",1,26
ext_juawagne,60,3,0,3,"5,00%","0,95",27
ext_mibrizue,60,11,0,11,"18,33%","81,67%",27
ext_matiam,40,0,0,0,"0,00%","100,00%",27
ext_sancjoaq,40,3,0,3,"7,50%","0,925",27
ext_masolvey,40,1,0,1,"2,50%","0,975",27
ext_facacuna,40,8,0,8,"20,00%","80,00%",27
ext_matvalle,40,0,0,0,"0,00%",1,27
ext_fltangor,40,12,0,12,"30,00%","0,7",27
ext_igjerez,40,0,0,0,"0,00%",1,27
ext_joastori,40,0,0,0,"0,00%",1,27
ext_tibareir,40,1,0,1,"2,50%","0,975",27
ext_jodragon,40,0,0,0,"0,00%",1,27
ext_namangas,40,0,0,0,"0,00%",1,27
ext_nadsosa,40,1,1,0,"2,50%","0,975",27
ext_ensole,40,0,0,0,"0,00%",1,27
ext_tovulcan,40,0,0,0,"0,00%",1,27
ext_kevvigil,40,0,0,0,"0,00%",1,27
ext_jotrimar,40,0,0,0,"0,00%",1,27
ext_toarruss,40,1,0,1,"2,50%","97,50%",27
ext_agnovare,40,0,0,0,"0,00%",1,27
ext_igcuevas,40,0,0,0,"0,00%","100,00%",27
ext_dadi,40,7,1,6,"17,50%","82,50%",27
ext_jocambar,40,8,4,4,"20,00%","0,8048780488",27
ext_ramiherr,40,0,0,0,"0,00%","100,00%",27
ext_ola,40,3,0,3,"7,50%","92,50%",27
ext_fagaglia,40,0,0,0,"0,00%","100,00%",27
ext_joavgust,40,11,9,2,"27,50%","0,7708333333",27
ext_fltangor,58,0,0,0,"0,00%",1,28
ext_joavgust,58,0,0,0,"0,00%",1,28
ext_facacuna,58,9,8,1,"15,52%","86,76%",28
ext_jocambar,52,8,1,7,"15,38%","0,8461538462",28
ext_toarruss,40,0,0,0,"0,00%","100,00%",28
ext_masolvey,40,4,0,4,"10,00%","0,9024390244",28
ext_elgramug,40,0,0,0,"0,00%",1,28
ext_jotrimar,40,0,0,0,"0,00%",1,28
ext_igcuevas,40,1,0,1,"2,50%","97,50%",28
ext_francof,40,8,1,7,"20,00%","0,8",28
ext_dadi,40,0,0,0,"0,00%","100,00%",28
ext_juawagne,40,1,0,1,"2,50%","0,975",28
ext_igjerez,40,0,0,0,"0,00%",1,28
ext_tibareir,38,0,0,0,"0,00%",1,28
ext_matvalle,38,0,0,0,"0,00%",1,28
ext_joastori,38,0,0,0,"0,00%",1,28
ext_nadsosa,38,6,0,6,"15,79%","0,8421052632",28
ext_namangas,33,1,1,0,"3,03%","0,9696969697",28
ext_ensole,32,1,1,0,"3,13%","0,96875",28
ext_fagaglia,32,3,0,3,"9,38%","90,63%",28
ext_kevvigil,32,3,3,0,"9,38%","0,90625",28
ext_matiam,32,11,0,11,"34,38%","65,63%",28
ext_jodragon,32,0,0,0,"0,00%",1,28
ext_ola,32,0,0,0,"0,00%","100,00%",28
ext_sancjoaq,32,8,0,8,"25,00%","0,8139534884",28
ext_tovulcan,32,3,2,1,"9,38%","0,9545454545",28
ext_ramiherr,32,13,0,13,"40,63%","59,38%",28
ext_agnovare,32,1,1,0,"3,13%","0,96875",28
ext_francof,50,3,0,3,"6,00%","0,94",29
ext_sancjoaq,50,6,1,5,"12,00%","0,88",29
ext_ramiherr,50,1,1,0,"2,00%","98,00%",29
ext_matiam,50,0,0,0,"0,00%","100,00%",29
ext_elgramug,40,0,0,0,"0,00%",1,29
ext_toarruss,40,0,0,0,"0,00%","100,00%",29
ext_ola,40,12,0,12,"30,00%","71,11%",29
ext_jocambar,40,15,0,15,"37,50%","0,625",29
ext_masolvey,40,9,0,9,"22,50%","0,775",29
ext_nadsosa,40,4,1,3,"10,00%","0,9",29
ext_tibareir,40,1,1,0,"2,50%","0,975",29
ext_joavgust,40,0,0,0,"0,00%",1,29
ext_jotrimar,40,0,0,0,"0,00%",1,29
ext_aiolmedo,40,0,0,0,"0,00%","100,00%",29
ext_joastori,40,5,0,5,"12,50%","0,875",29
ext_namangas,40,0,0,0,"0,00%",1,29
ext_dadi,40,0,0,0,"0,00%","100,00%",29
ext_agnovare,40,1,0,1,"2,50%","0,975",29
ext_igcuevas,40,0,0,0,"0,00%","100,00%",29
ext_fltangor,40,2,2,0,"5,00%","0,9534883721",29
ext_fagaglia,40,2,1,1,"5,00%","95,00%",29
ext_mibrizue,40,0,0,0,"0,00%","100,00%",29
ext_jodragon,40,0,0,0,"0,00%",1,29
ext_igjerez,40,0,0,0,"0,00%",1,29
ext_matvalle,40,0,0,0,"0,00%",1,29
ext_tovulcan,40,0,0,0,"0,00%",1,29
ext_facacuna,40,1,0,1,"2,50%","97,50%",29
ext_ensole,40,25,14,11,"62,50%","0,375",29
ext_juawagne,40,0,0,0,"0,00%",1,29
ext_jocambar,60,2,1,1,"3,33%","0,9666666667",30
ext_ensole,60,2,0,2,"3,33%","0,9666666667",30
ext_namangas,40,1,0,1,"2,50%","0,975",30
ext_facacuna,40,3,3,0,"7,50%","92,50%",30
ext_joastori,40,4,3,1,"10,00%","0,9",30
ext_nadsosa,40,18,2,16,"45,00%","0,431372549",30
ext_ola,40,4,0,4,"10,00%","90,24%",30
ext_fltangor,40,5,0,5,"12,50%","0,875",30
ext_igcuevas,40,0,0,0,"0,00%","100,00%",30
ext_igjerez,40,0,0,0,"0,00%",1,30
ext_tibareir,40,5,5,0,"12,50%","0,8936170213",30
ext_jodragon,40,1,0,1,"2,50%","0,9772727273",30
ext_matvalle,40,0,0,0,"0,00%",1,30
ext_sancjoaq,40,0,0,0,"0,00%",1,30
ext_ramiherr,40,0,0,0,"0,00%","100,00%",30
ext_fagaglia,40,3,1,2,"7,50%","92,50%",30
ext_francof,40,8,0,8,"20,00%","0,8392857143",30
ext_elgramug,40,0,0,0,"0,00%",1,30
ext_dadi,40,0,0,0,"0,00%","100,00%",30
ext_masolvey,40,0,0,0,"0,00%",1,30
ext_toarruss,40,11,0,11,"27,50%","72,50%",30
ext_juawagne,40,7,7,0,"17,50%","0,825",30
ext_aiolmedo,40,0,0,0,"0,00%","100,00%",30
ext_jotrimar,40,0,0,0,"0,00%",1,30
ext_joavgust,40,0,0,0,"0,00%",1,30
ext_mibrizue,40,2,1,1,"5,00%","95,00%",30
ext_tovulcan,40,0,0,0,"0,00%",1,30
ext_agnovare,40,0,0,0,"0,00%",1,30
ext_matiam,40,0,0,0,"0,00%","100,00%",30
ext_igcuevas,80,5,3,2,"6,25%","93,75%",31
ext_toarruss,80,9,7,2,"11,25%","88,75%",31
ext_fltangor,80,1,0,1,"1,25%","0,9875",31
ext_dadi,40,7,1,6,"17,50%","82,50%",31
ext_facacuna,40,4,3,1,"10,00%","90,00%",31
ext_igjerez,40,2,0,2,"5,00%","0,95",31
ext_jodragon,40,1,0,1,"2,50%","0,975",31
ext_ramiherr,40,3,0,3,"7,50%","92,50%",31
ext_jocambar,40,5,1,4,"12,50%","0,890625",31
ext_francof,40,0,0,0,"0,00%",1,31
ext_fagaglia,40,1,0,1,"2,50%","97,73%",31
ext_sancjoaq,40,12,3,9,"30,00%","0,7",31
ext_agnovare,40,0,0,0,"0,00%",1,31
ext_tovulcan,40,1,0,1,"2,50%","0,975",31
ext_aiolmedo,40,0,0,0,"0,00%","100,00%",31
ext_matvalle,40,0,0,0,"0,00%",1,31
ext_joastori,40,5,0,5,"12,50%","0,875",31
ext_ensole,40,0,0,0,"0,00%",1,31
ext_ola,40,13,0,13,"32,50%","67,50%",31
ext_mibrizue,40,1,0,1,"2,50%","97,50%",31
ext_tibareir,40,3,0,3,"7,50%","0,9302325581",31
ext_namangas,40,2,2,0,"5,00%","0,95",31
ext_juawagne,40,0,0,0,"0,00%",1,31
ext_joavgust,40,3,0,3,"7,50%","0,925",31
ext_elgramug,40,3,0,3,"7,50%","0,925",31
ext_nadsosa,40,0,0,0,"0,00%",1,31
ext_ola,60,31,9,22,"51,67%","48,33%",32
ext_joastori,60,0,0,0,"0,00%",1,32
ext_dadi,60,5,1,4,"8,33%","91,67%",32
ext_sancjoaq,52,3,0,3,"5,77%","0,9454545455",32
ext_ramiherr,48,6,0,6,"12,50%","87,50%",32
ext_nadsosa,43,0,0,0,"0,00%",1,32
ext_joavgust,42,0,0,0,"0,00%",1,32
ext_tibareir,41,6,0,6,"14,63%","0,8536585366",32
ext_fltangor,41,0,0,0,"0,00%",1,32
ext_matiam,40,3,3,0,"7,50%","92,50%",32
ext_mibrizue,40,0,0,0,"0,00%","100,00%",32
ext_agnovare,40,3,3,0,"7,50%","0,9268292683",32
ext_francof,40,2,0,2,"5,00%","0,95",32
ext_ensole,40,1,0,1,"2,50%","0,975",32
ext_jotrimar,40,2,1,1,"5,00%","0,95",32
ext_jodragon,40,0,0,0,"0,00%",1,32
ext_fagaglia,40,3,0,3,"7,50%","92,50%",32
ext_toarruss,40,6,0,6,"15,00%","85,00%",32
ext_namangas,40,6,0,6,"15,00%","0,85",32
ext_facacuna,40,0,0,0,"0,00%","100,00%",32
ext_juawagne,40,7,3,4,"17,50%","0,825",32
ext_elgramug,40,4,0,4,"10,00%","0,9",32
ext_jocambar,40,6,1,5,"15,00%","0,85",32
ext_matvalle,40,4,3,1,"10,00%","0,9024390244",32
ext_igcuevas,40,13,0,13,"32,50%","67,50%",32
ext_aiolmedo,40,0,0,0,"0,00%","100,00%",32
ext_tovulcan,40,7,5,2,"17,50%","0,825",32
ext_tovulcan,52,4,0,4,"7,69%","0,9230769231",33
ext_ola,50,14,3,11,"28,00%","73,58%",33
ext_juawagne,50,2,2,0,"4,00%","0,96",33
ext_igcuevas,50,0,0,0,"0,00%","100,00%",33
ext_dadi,44,1,0,1,"2,27%","97,73%",33
ext_jodragon,41,0,0,0,"0,00%",1,33
ext_ramiherr,41,0,0,0,"0,00%","100,00%",33
ext_jocambar,41,0,0,0,"0,00%",1,33
ext_namangas,41,0,0,0,"0,00%",1,33
ext_sancjoaq,41,0,0,0,"0,00%",1,33
ext_facacuna,40,2,1,1,"5,00%","95,00%",33
ext_mibrizue,40,3,1,2,"7,50%","92,50%",33
ext_aiolmedo,40,0,0,0,"0,00%","100,00%",33
ext_igjerez,40,3,2,1,"7,50%","0,925",33
ext_elgramug,40,1,0,1,"2,50%","0,975",33
ext_tibareir,40,0,0,0,"0,00%",1,33
ext_matiam,40,1,0,1,"2,50%","97,62%",33
ext_ensole,40,5,0,5,"12,50%","0,9107142857",33
ext_nadsosa,40,1,0,1,"2,50%","0,975",33
ext_fagaglia,40,11,2,9,"27,50%","72,50%",33
ext_francof,40,0,0,0,"0,00%",1,33
ext_joastori,40,1,1,0,"2,50%","0,975",33
ext_joavgust,40,14,13,1,"35,00%","0,65",33
ext_jotrimar,40,0,0,0,"0,00%",1,33
ext_matvalle,40,13,3,10,"32,50%","0,675",33
ext_agnovare,40,0,0,0,"0,00%",1,33
ext_fltangor,40,6,3,3,"15,00%","0,85",33
ext_toarruss,36,0,0,0,"0,00%","100,00%",33
ext_fltangor,50,14,10,4,"28,00%","0,7307692308",34
ext_ola,50,0,0,0,"0,00%","100,00%",34
ext_fagaglia,47,16,8,8,"34,04%","65,96%",34
ext_joavgust,47,24,12,12,"51,06%","0,4893617021",34
ext_matvalle,47,1,0,1,"2,13%","0,9787234043",34
ext_jocambar,40,4,4,0,"10,00%","0,9",34
ext_matiam,40,0,0,0,"0,00%","100,00%",34
ext_joastori,40,5,5,0,"12,50%","0,875",34
ext_toarruss,40,1,1,0,"2,50%","97,78%",34
ext_tovulcan,40,1,0,1,"2,50%","0,975",34
ext_ramiherr,40,1,0,1,"2,50%","97,50%",34
ext_namangas,40,3,1,2,"7,50%","0,925",34
ext_nadsosa,40,1,0,1,"2,50%","0,975",34
ext_jodragon,40,0,0,0,"0,00%",1,34
ext_igjerez,40,1,1,0,"2,50%","0,975",34
ext_agnovare,40,2,0,2,"5,00%","0,95",34
ext_tibareir,40,1,1,0,"2,50%","0,975",34
ext_jotrimar,40,0,0,0,"0,00%",1,34
ext_ensole,40,8,6,2,"20,00%","0,8",34
ext_mibrizue,40,3,0,3,"7,50%","90,48%",34
ext_igcuevas,40,1,1,0,"2,50%","97,50%",34
ext_francof,40,1,0,1,"2,50%","0,975",34
ext_aiolmedo,40,0,0,0,"0,00%","100,00%",34
ext_facacuna,40,13,2,11,"32,50%","65,85%",34
ext_sancjoaq,40,6,5,1,"15,00%","0,85",34
ext_juawagne,40,0,0,0,"0,00%",1,34
ext_elgramug,40,0,0,0,"0,00%",1,34
ext_dadi,39,1,0,1,"2,56%","97,44%",34
ext_joavgust,50,9,0,9,"0,18","0,82",35
ext_fltangor,45,3,1,2,"0,06666666667","0,9375",35
ext_facacuna,45,10,1,9,"0,2222222222","0,7777777778",35
ext_francof,40,6,0,6,"0,15","0,85",35
ext_dadi,30,2,0,2,"0,06666666667","0,9333333333",35
ext_sancjoaq,30,0,0,0,0,1,35
ext_ola,30,0,0,0,0,1,35
ext_nadsosa,30,0,0,0,0,1,35
ext_agnovare,30,0,0,0,0,1,35
ext_aiolmedo,30,0,0,0,0,1,35
ext_matiam,30,1,0,1,"0,03333333333","0,9666666667",35
ext_jodragon,30,0,0,0,0,1,35
ext_ramiherr,30,7,0,7,"0,2333333333","0,7741935484",35
ext_ensole,30,0,0,0,0,1,35
ext_juawagne,30,0,0,0,0,1,35
ext_jotrimar,30,0,0,0,0,1,35
ext_joastori,30,2,0,2,"0,06666666667","0,9333333333",35
ext_tibareir,30,0,0,0,0,1,35
ext_matvalle,30,0,0,0,0,1,35
ext_toarruss,30,0,0,0,0,1,35
ext_mibrizue,30,0,0,0,0,1,35
ext_igjerez,30,1,1,0,"0,03333333333","0,96875",35
ext_jocambar,30,8,4,4,"0,2666666667","0,7333333333",35
ext_namangas,30,0,0,0,0,1,35
ext_elgramug,30,0,0,0,0,1,35
ext_igcuevas,30,9,8,1,"0,3","0,7",35
ext_tovulcan,29,2,0,2,"0,06896551724","0,9310344828",35
ext_igcuevas,60,7,1,6,"0,1166666667","0,8833333333",36
ext_jocambar,60,0,0,0,0,1,36
ext_facacuna,50,0,0,0,0,1,36
ext_ramiherr,50,1,0,1,"0,02","0,98",36
ext_francof,50,5,0,5,"0,1","0,9",36
ext_fagaglia,30,1,0,1,"0,03333333333","0,9666666667",36
ext_elgramug,30,1,0,1,"0,03333333333","0,9666666667",36
ext_ola,30,8,7,1,"0,2666666667","0,7333333333",36
ext_igjerez,30,3,1,2,"0,1","0,90625",36
ext_matiam,30,1,0,1,"0,03333333333","0,9666666667",36
ext_jodragon,30,0,0,0,0,1,36
ext_juawagne,30,3,1,2,"0,1","0,9",36
ext_nadsosa,30,10,2,8,"0,3333333333","0,6666666667",36
ext_fltangor,30,0,0,0,0,1,36
ext_matvalle,30,0,0,0,0,1,36
ext_toarruss,30,0,0,0,0,1,36
ext_jotrimar,30,0,0,0,0,1,36
ext_tovulcan,30,3,0,3,"0,1","0,9",36
ext_dadi,30,0,0,0,0,1,36
ext_sancjoaq,30,5,1,4,"0,1666666667","0,8863636364",36
ext_namangas,30,1,0,1,"0,03333333333","0,9459459459",36
ext_joastori,30,2,0,2,"0,06666666667","0,9333333333",36
ext_ensole,30,0,0,0,0,1,36
ext_agnovare,30,1,1,0,"0,03333333333","0,9666666667",36
ext_mibrizue,30,0,0,0,0,1,36
ext_joavgust,67,4,4,0,"0,05970149254","0,9402985075",37
ext_ola,50,0,0,0,0,1,37
ext_matvalle,44,1,0,1,"0,02272727273","0,9772727273",37
ext_fltangor,44,0,0,0,0,1,37
ext_nadsosa,41,1,1,0,"0,0243902439","0,9756097561",37
ext_igcuevas,41,2,1,1,"0,0487804878","0,9512195122",37
ext_sancjoaq,41,17,17,0,"0,4146341463","0,6326530612",37
ext_jocambar,37,1,0,1,"0,02702702703","0,972972973",37
ext_jodragon,35,2,2,0,"0,05714285714","0,9428571429",37
ext_toarruss,35,0,0,0,0,1,37
ext_namangas,35,5,0,5,"0,1428571429","0,8571428571",37
ext_igjerez,35,2,0,2,"0,05714285714","0,9428571429",37
ext_mibrizue,35,0,0,0,0,1,37
ext_ensole,35,5,5,0,"0,1428571429","0,8571428571",37
ext_matiam,35,0,0,0,0,1,37
ext_elgramug,35,1,0,1,"0,02857142857","0,9714285714",37
ext_francof,35,9,9,0,"0,2571428571","0,7428571429",37
ext_fagaglia,35,1,0,1,"0,02857142857","0,9714285714",37
ext_tovulcan,35,1,0,1,"0,02857142857","0,9714285714",37
ext_dadi,35,2,0,2,"0,05714285714","0,9428571429",37
ext_jotrimar,35,0,0,0,0,1,37
ext_agnovare,35,0,0,0,0,1,37
ext_joastori,35,6,0,6,"0,1714285714","0,8285714286",37
ext_facacuna,34,0,0,0,0,1,37
ext_juawagne,33,2,2,0,"0,06060606061","0,9393939394",37
ext_aiolmedo,12,0,0,0,0,1,37
ext_tibareir,11,1,1,0,"0,09090909091","0,9090909091",37
ext_sancjoaq,50,0,0,0,0,1,38
ext_igcuevas,42,6,0,6,"0,1428571429","0,88",38
ext_fagaglia,42,8,0,8,"0,1904761905","0,8095238095",38
ext_fltangor,35,0,0,0,0,1,38
ext_ensole,35,0,0,0,0,1,38
ext_jocambar,35,7,0,7,"0,2","0,8",38
ext_nadsosa,35,2,0,2,"0,05714285714","0,9428571429",38
ext_ola,35,2,0,2,"0,05714285714","0,9487179487",38
ext_facacuna,35,11,0,11,"0,3142857143","0,7027027027",38
ext_matvalle,35,2,0,2,"0,05714285714","0,9428571429",38
ext_elgramug,28,0,0,0,0,1,38
ext_francof,28,0,0,0,0,1,38
ext_namangas,28,0,0,0,0,1,38
ext_tovulcan,28,0,0,0,0,1,38
ext_jodragon,28,2,2,0,"0,07142857143","0,9285714286",38
ext_juawagne,28,3,3,0,"0,1071428571","0,8928571429",38
ext_joastori,28,0,0,0,0,1,38
ext_toarruss,28,0,0,0,0,1,38
ext_matiam,28,0,0,0,0,1,38
ext_joavgust,28,1,0,1,"0,03571428571","0,9642857143",38
ext_ramiherr,28,0,0,0,0,1,38
ext_jotrimar,28,4,0,4,"0,1428571429","0,8571428571",38
ext_dadi,28,0,0,0,0,1,38
ext_mibrizue,28,2,0,2,"0,07142857143","0,9285714286",38
ext_igjerez,28,0,0,0,0,1,38
ext_agnovare,28,1,0,1,"0,03571428571","0,9642857143",38