Usuario,IDs auditados,Total errores,Error LEVE,Error GRAVE,% error,% de efectividad,Week
ext_gutifran,199,1,0,1,"0,50%","99,50%",1
ext_jotrimar,161,20,11,9,"12,42%","87,58%",1
ext_namangas,159,60,15,45,"37,74%","62,26%",1
ext_fagaglia,144,20,4,16,"13,89%","86,11%",1
ext_canatura,143,33,15,18,"23,08%","76,92%",1
ext_mapeppe,120,15,12,3,"12,50%","87,50%",1
ext_martga,107,23,10,13,"21,50%","78,50%",1
ext_joavgust,99,17,0,17,"17,17%","83,65%",1
ext_joastori,94,11,3,8,"11,70%","88,30%",1
ext_masolvey,93,39,2,37,"41,94%","58,06%",1
ext_mibrizue,74,5,1,4,"6,76%","93,24%",1
ext_igpachec,68,29,17,12,"42,65%","57,35%",1
ext_ola,55,15,10,5,"27,27%","72,73%",1
ext_sancjoaq,34,0,0,0,"0,00%","100,00%",1
ext_mibrizue,127,3,1,2,"2,36%","97,53%",2
ext_igjerez,122,1,0,1,"0,82%","99,18%",2
ext_jotrimar,115,5,3,2,"4,35%","95,65%",2
ext_fagaglia,100,3,2,1,"3,00%","97,00%",2
ext_masolvey,82,10,7,3,"12,20%","87,80%",2
ext_agnovare,64,2,2,0,"3,13%","96,88%",2
ext_lopmatia,58,7,0,7,"12,07%","87,93%",2
ext_matiam,53,3,2,1,"5,66%","94,34%",2
ext_ola,45,2,0,2,"4,44%","95,56%",2
ext_maabrigo,39,0,0,0,"0,00%","100,00%",2
ext_aiolmedo,33,1,0,1,"3,03%","96,97%",2
ext_nadsosa,30,4,1,3,"13,33%","86,67%",2
ext_jodragon,25,0,0,0,"0,00%","100,00%",2
ext_canatura,227,56,9,47,"24,67%","75,33%",3
ext_masolvey,162,38,20,18,"23,46%","81,00%",3
ext_mibrizue,155,10,3,7,"6,45%","94,05%",3
ext_sancjoaq,140,40,37,3,"28,57%","71,43%",3
ext_igjerez,130,11,3,8,"8,46%","90,98%",3
ext_joavgust,129,4,0,4,"3,10%","96,90%",3
ext_fagaglia,120,2,1,1,"1,67%","98,45%",3
ext_agnovare,119,0,0,0,"0,00%","100,00%",3
ext_lopmatia,100,5,5,0,"5,00%","95,00%",3
ext_martga,64,13,3,10,"20,31%","81,61%",3
ext_canatura,127,22,0,22,"17,32%","82,68%",4
ext_namangas,109,25,0,25,"22,94%","77,06%",4
ext_joavgust,96,0,0,0,"0,00%","100,00%",4
ext_masolvey,92,18,17,1,"19,57%","80,43%",4
ext_martga,91,9,0,9,"9,89%","90,11%",4
ext_mibrizue,90,6,3,3,"6,67%","93,33%",4
ext_gutifran,80,3,1,2,"3,75%","96,25%",4
ext_fagaglia,70,3,0,3,"4,29%","95,71%",4
ext_lopmatia,62,6,2,4,"9,68%","90,32%",4
ext_igjerez,48,2,0,2,"4,17%","95,83%",4
ext_jotrimar,44,0,0,0,"0,00%","100,00%",4
ext_ola,37,0,0,0,"0,00%","100,00%",4
ext_joastori,32,0,0,0,"0,00%","100,00%",4
ext_jodragon,29,2,0,2,"6,90%","93,10%",4
ext_nadsosa,24,0,0,0,"0,00%","100,00%",4
ext_sancjoaq,15,0,0,0,"0,00%","100,00%",4
ext_tibareir,291,3,0,3,"1,03%","98,97%",5
ext_igjerez,229,30,17,13,"13,10%","86,90%",5
ext_namangas,225,43,17,26,"19,11%","80,89%",5
ext_martga,179,52,25,27,"29,05%","71,27%",5
ext_sancjoaq,166,53,1,52,"31,93%","68,07%",5
ext_gutifran,149,0,0,0,"0,00%","100,00%",5
ext_agnovare,131,0,0,0,"0,00%","100,00%",5
ext_joastori,126,29,10,19,"23,02%","76,98%",5
ext_masolvey,116,4,4,0,"3,45%","96,55%",5
ext_canatura,97,8,7,1,"8,25%","91,75%",5
ext_jotrimar,97,1,0,1,"1,03%","98,97%",5
ext_joavgust,92,19,9,10,"20,65%","79,35%",5
ext_mibrizue,87,21,14,7,"24,14%","77,42%",5
ext_ola,86,17,0,17,"19,77%","80,23%",5
ext_matiam,65,1,0,1,"1,54%","98,46%",5
ext_nadsosa,35,9,0,9,"25,71%","74,29%",5
ext_aiolmedo,27,4,0,4,"14,81%","85,19%",5
ext_jodragon,26,0,0,0,"0,00%","100,00%",5
ext_jotrimar,211,8,0,8,"3,79%","96,21%",6
ext_fagaglia,198,14,0,14,"7,07%","93,20%",6
ext_masolvey,139,12,5,7,"8,63%","91,37%",6
ext_magrodon,121,24,3,21,"19,83%","80,17%",6
ext_igjerez,112,13,0,13,"11,61%","90,30%",6
ext_canatura,110,14,3,11,"12,73%","90,21%",6
ext_gutifran,108,17,0,17,"15,74%","84,26%",6
ext_nadsosa,106,0,0,0,"0,00%","100,00%",6
ext_matiam,104,28,3,25,"26,92%","73,08%",6
ext_agnovare,92,17,14,3,"18,48%","81,52%",6
ext_aiolmedo,90,19,19,0,"21,11%","81,00%",6
ext_facacuna,90,2,0,2,"2,22%","97,78%",6
ext_namangas,86,6,0,6,"6,98%","93,02%",6
ext_ola,81,11,2,9,"13,58%","88,00%",6
ext_tovulcan,80,14,2,12,"17,50%","82,50%",6
ext_mibrizue,79,3,3,0,"3,80%","96,20%",6
ext_jodragon,64,1,0,1,"1,56%","98,44%",6
ext_joastori,53,2,0,2,"3,77%","96,23%",6
ext_sancjoaq,50,7,4,3,"14,00%","86,00%",6
ext_martga,45,20,3,17,"44,44%","55,32%",6
ext_juawagne,39,1,0,1,"2,56%","97,44%",6
ext_jocambar,37,29,4,25,"78,38%","21,62%",6
ext_joavgust,30,4,0,4,"13,33%","86,67%",6
ext_tibareir,3,0,0,0,"0,00%","100,00%",6
ext_ola,294,9,1,8,"3,06%","96,94%",7
ext_facacuna,177,8,0,8,"4,52%","95,48%",7
ext_canatura,148,14,2,12,"9,46%","90,54%",7
ext_juawagne,138,35,27,8,"25,36%","76,35%",7
ext_jocambar,132,22,1,21,"16,67%","85,71%",7
ext_namangas,90,2,0,2,"2,22%","97,78%",7
ext_fagaglia,89,5,3,2,"5,62%","94,38%",7
ext_tovulcan,80,14,13,1,"17,50%","82,50%",7
ext_mibrizue,74,32,30,2,"43,24%","56,76%",7
ext_nadsosa,67,23,23,0,"34,33%","65,67%",7
ext_joavgust,60,5,0,5,"8,33%","91,67%",7
ext_jodragon,56,8,3,5,"14,29%","85,71%",7
ext_magrodon,51,1,1,0,"1,96%","98,04%",7
ext_jotrimar,46,0,0,0,"0,00%","100,00%",7
ext_matiam,31,3,0,3,"9,68%","90,32%",7
ext_gutifran,23,0,0,0,"0,00%","100,00%",7
ext_masolvey,20,0,0,0,"0,00%","100,00%",7
ext_aiolmedo,6,0,0,0,"0,00%","100,00%",7
ext_igjerez,6,0,0,0,"0,00%","100,00%",7
ext_canatura,119,19,1,18,"15,97%","84,03%",8
ext_fagaglia,114,9,8,1,"7,89%","92,17%",8
ext_aiolmedo,69,1,0,1,"1,45%","98,55%",8
ext_gutifran,64,12,5,7,"18,75%","81,25%",8
ext_igjerez,62,0,0,0,"0,00%","100,00%",8
ext_jodragon,50,1,0,1,"2,00%","98,00%",8
ext_jocambar,50,3,1,2,"6,00%","94,00%",8
ext_namangas,50,7,1,6,"14,00%","86,00%",8
ext_ola,44,11,3,8,"25,00%","75,00%",8
ext_joavgust,44,18,6,12,"40,91%","59,09%",8
ext_tovulcan,41,6,0,6,"14,63%","85,37%",8
ext_facacuna,41,9,2,7,"21,95%","78,05%",8
ext_masolvey,40,1,0,1,"2,50%","97,50%",8
ext_matiam,29,0,0,0,"0,00%","100,00%",8
ext_magrodon,24,0,0,0,"0,00%","100,00%",8
ext_mibrizue,15,6,6,0,"40,00%","60,00%",8
ext_nadsosa,13,2,0,2,"15,38%","84,62%",8
ext_agnovare,4,1,1,0,"25,00%","60,00%",8
ext_masolvey,357,34,5,29,"9,52%","90,48%",9
ext_ola,293,28,9,19,"9,56%","90,44%",9
ext_namangas,94,13,0,13,"13,83%","86,17%",9
ext_jocambar,90,7,1,6,"7,78%","92,22%",9
ext_igjerez,79,3,0,3,"3,80%","96,20%",9
ext_aiolmedo,65,0,0,0,"0,00%","100,00%",9
ext_jodragon,62,3,2,1,"4,84%","95,16%",9
ext_nadsosa,52,10,1,9,"19,23%","80,77%",9
ext_magrodon,45,5,4,1,"11,11%","88,89%",9
ext_agnovare,37,9,7,2,"24,32%","75,68%",9
ext_matiam,27,0,0,0,"0,00%","100,00%",9
ext_gutifran,19,1,0,1,"5,26%","94,74%",9
ext_fagaglia,13,2,0,2,"15,38%","84,62%",9
ext_juawagne,10,0,0,0,"0,00%","100,00%",9
ext_joavgust,2,1,0,1,"50,00%","50,00%",9
ext_jodragon,94,0,0,0,"0,00%","100,00%",10
ext_kevvigil,82,20,8,12,"24,39%","75,61%",10
ext_facacuna,73,18,4,14,"24,66%","75,34%",10
ext_canatura,67,0,0,0,"0,00%","100,00%",10
ext_toarruss,60,9,0,9,"15,00%","85,00%",10
ext_jocambar,40,14,5,9,"35,00%","65,00%",10
ext_namangas,39,0,0,0,"0,00%","100,00%",10
ext_joastori,30,2,0,2,"6,67%","93,33%",10
ext_ola,28,12,0,12,"42,86%","57,14%",10
ext_fltangor,24,1,1,0,"4,17%","95,83%",10
ext_jotrimar,10,0,0,0,"0,00%","100,00%",10
ext_masolvey,8,0,0,0,"0,00%","100,00%",10
ext_mibrizue,7,0,0,0,"0,00%","100,00%",10
ext_jocambar,216,13,2,11,"6,02%","93,98%",11
ext_kevvigil,169,55,53,2,"32,54%","67,46%",11
ext_toarruss,129,32,16,16,"24,81%","75,19%",11
ext_fltangor,120,11,1,10,"9,17%","90,83%",11
ext_jodragon,77,1,0,1,"1,30%","98,70%",11
ext_nadsosa,70,0,0,0,"0,00%","100,00%",11
ext_masolvey,34,4,2,2,"11,76%","88,24%",11
ext_gutifran,31,0,0,0,"0,00%","100,00%",11
ext_fagaglia,30,0,0,0,"0,00%","100,00%",11
ext_ola,28,0,0,0,"0,00%","100,00%",11
ext_tovulcan,25,1,0,1,"4,00%","96,00%",11
ext_agnovare,23,0,0,0,"0,00%","100,00%",11
ext_aiolmedo,22,0,0,0,"0,00%","100,00%",11
ext_facacuna,20,2,0,2,"10,00%","90,00%",11
ext_matiam,19,0,0,0,"0,00%","100,00%",11
ext_canatura,13,2,1,1,"15,38%","84,62%",11
ext_sancjoaq,10,0,0,0,"0,00%","100,00%",11
ext_jotrimar,8,0,0,0,"0,00%","100,00%",11
ext_joastori,4,0,0,0,"0,00%","100,00%",11
ext_juawagne,4,2,2,0,"50,00%","50,00%",11
ext_tibareir,4,0,0,0,"0,00%","100,00%",11
ext_igjerez,3,0,0,0,"0,00%","100,00%",11
ext_magrodon,1,0,0,0,"0,00%","100,00%",11
ext_mibrizue,1,0,0,0,"0,00%","100,00%",11
ext_tovulcan,140,37,0,37,"26,43%","73,57%",12
ext_kevvigil,114,8,0,8,"7,02%","92,98%",12
ext_facacuna,107,33,8,25,"30,84%","69,16%",12
ext_juawagne,68,0,0,0,"0,00%","100,00%",12
ext_canatura,68,29,0,29,"42,65%","57,35%",12
ext_toarruss,54,2,1,1,"3,70%","96,30%",12
ext_joavgust,52,0,0,0,"0,00%","100,00%",12
ext_jodragon,51,3,0,3,"5,88%","94,12%",12
ext_jocambar,44,11,10,1,"25,00%","75,00%",12
ext_masolvey,42,1,0,1,"2,38%","97,62%",12
ext_mibrizue,39,5,1,4,"12,82%","87,18%",12
ext_tibareir,28,2,0,2,"7,14%","92,86%",12
ext_fltangor,27,3,1,2,"11,11%","88,89%",12
ext_magrodon,24,1,1,0,"4,17%","95,83%",12
ext_matiam,22,2,0,2,"9,09%","90,91%",12
ext_joastori,20,0,0,0,"0,00%","100,00%",12
ext_ola,17,2,1,1,"11,76%","88,24%",12
ext_nadsosa,14,7,0,7,"50,00%","50,00%",12
ext_igjerez,12,2,0,2,"16,67%","83,33%",12
ext_aiolmedo,11,0,0,0,"0,00%","100,00%",12
ext_fagaglia,10,2,1,1,"20,00%","80,00%",12
ext_namangas,7,0,0,0,"0,00%","100,00%",12
ext_gutifran,7,1,0,1,"14,29%","85,71%",12
ext_jotrimar,4,0,0,0,"0,00%","100,00%",12
ext_kevvigil,368,123,107,16,"33,42%","66,76%",13
ext_toarruss,343,97,84,13,"28,28%","69,27%",13
ext_tovulcan,232,65,23,42,"28,02%","71,67%",13
ext_facacuna,131,56,4,52,"42,75%","55,80%",13
ext_enheredi,130,17,5,12,"13,08%","86,92%",13
ext_fagaglia,109,1,0,1,"0,92%","99,17%",13
ext_matiam,92,2,0,2,"2,17%","98,10%",13
ext_ramiherr,92,16,0,16,"17,39%","71,70%",13
ext_canatura,77,23,7,16,"29,87%","70,13%",13
ext_aiolmedo,52,0,0,0,"0,00%","100,00%",13
ext_igjerez,46,4,0,4,"8,70%","91,30%",13
ext_jocambar,45,16,16,0,"35,56%","64,44%",13
ext_nadsosa,45,0,0,0,"0,00%","100,00%",13
ext_matvalle,28,8,4,4,"28,57%","71,43%",13
ext_mibrizue,27,0,0,0,"0,00%","100,00%",13
ext_agnovare,23,0,0,0,"0,00%","100,00%",13
ext_joastori,21,1,0,1,"4,76%","95,24%",13
ext_tibareir,20,0,0,0,"0,00%","100,00%",13
ext_ola,16,5,0,5,"31,25%","68,75%",13
ext_fltangor,14,5,2,3,"35,71%","64,29%",13
ext_sancjoaq,13,0,0,0,"0,00%","100,00%",13
ext_juawagne,11,6,4,2,"54,55%","45,45%",13
ext_namangas,8,4,0,4,"50,00%","50,00%",13
ext_joavgust,3,1,1,0,"33,33%","66,67%",13
ext_masolvey,1,0,0,0,"0,00%","100,00%",13
ext_tovulcan,245,16,4,12,"6,53%","93,60%",14
ext_kevvigil,113,14,3,11,"12,39%","87,60%",14
ext_fltangor,109,8,0,8,"7,34%","92,66%",14
ext_toarruss,103,14,4,10,"13,59%","86,54%",14
ext_agnovare,93,0,0,0,"0,00%","100,00%",14
ext_enheredi,85,4,2,2,"4,71%","95,29%",14
ext_ramiherr,79,7,3,4,"8,86%","90,00%",14
ext_matiam,78,2,0,2,"2,56%","97,44%",14
ext_matvalle,78,17,14,3,"21,79%","78,21%",14
ext_juawagne,75,4,1,3,"5,33%","94,67%",14
ext_facacuna,74,17,1,16,"22,97%","77,03%",14
ext_canatura,74,6,0,6,"8,11%","91,89%",14
ext_joastori,73,0,0,0,"0,00%","100,00%",14
ext_joavgust,58,1,1,0,"1,72%","98,31%",14
ext_sancjoaq,51,6,0,6,"11,76%","88,24%",14
ext_tibareir,41,1,1,0,"2,44%","97,92%",14
ext_mibrizue,34,2,1,1,"5,88%","94,12%",14
ext_fagaglia,33,3,0,3,"9,09%","90,91%",14
ext_igjerez,29,0,0,0,"0,00%","100,00%",14
ext_namangas,20,0,0,0,"0,00%","100,00%",14
ext_jodragon,17,0,0,0,"0,00%","100,00%",14
ext_masolvey,14,1,0,1,"7,14%","92,86%",14
ext_aiolmedo,13,0,0,0,"0,00%","100,00%",14
ext_jocambar,12,0,0,0,"0,00%","100,00%",14
ext_jotrimar,10,0,0,0,"0,00%","100,00%",14
ext_ola,9,0,0,0,"0,00%","100,00%",14
ext_nadsosa,7,2,0,2,"28,57%","71,43%",14
ext_kevvigil,208,32,25,7,"15,38%","84,76%",15
ext_jocambar,157,14,6,8,"8,92%","91,41%",15
ext_ola,136,11,5,6,"8,09%","91,91%",15
ext_mibrizue,109,15,13,2,"13,76%","87,39%",15
ext_toarruss,103,10,5,5,"9,71%","90,48%",15
ext_joastori,101,2,0,2,"1,98%","98,15%",15
ext_jodragon,82,0,0,0,"0,00%","100,00%",15
ext_juawagne,67,5,2,3,"7,46%","89,86%",15
ext_masolvey,62,0,0,0,"0,00%","100,00%",15
ext_matvalle,56,1,1,0,"1,79%","98,21%",15
ext_joavgust,48,4,4,0,"8,33%","94,74%",15
ext_namangas,38,1,0,1,"2,63%","97,37%",15
ext_fagaglia,38,0,0,0,"0,00%","100,00%",15
ext_tibareir,32,0,0,0,"0,00%","100,00%",15
ext_tovulcan,30,13,13,0,"43,33%","56,67%",15
ext_agnovare,30,0,0,0,"0,00%","100,00%",15
ext_sancjoaq,29,6,3,3,"20,69%","79,31%",15
ext_fltangor,24,2,2,0,"8,33%","91,67%",15
ext_facacuna,24,11,2,9,"45,83%","54,17%",15
ext_ramiherr,23,0,0,0,"0,00%","100,00%",15
ext_jotrimar,22,0,0,0,"0,00%","100,00%",15
ext_matiam,22,1,1,0,"4,55%","95,45%",15
ext_enheredi,21,1,1,0,"4,76%","95,24%",15
ext_aiolmedo,3,0,0,0,"0,00%","100,00%",15
ext_nadsosa,2,0,0,0,"0,00%","100,00%",15
ext_matiam,157,1,0,1,"0,64%","99,38%",16
ext_fagaglia,102,6,2,4,"5,88%","93,27%",16
ext_kevvigil,86,3,0,3,"3,49%","96,51%",16
ext_tovulcan,68,27,11,16,"39,71%","61,97%",16
ext_toarruss,63,12,2,10,"19,05%","80,95%",16
ext_igjerez,54,0,0,0,"0,00%","100,00%",16
ext_jocambar,53,3,1,2,"5,66%","94,34%",16
ext_ramiherr,52,5,0,5,"9,62%","90,38%",16
ext_mibrizue,48,2,0,2,"4,17%","95,83%",16
ext_enheredi,37,14,0,14,"37,84%","62,16%",16
ext_joavgust,26,1,0,1,"3,85%","92,59%",16
ext_facacuna,25,12,1,11,"48,00%","53,57%",16
ext_agnovare,15,0,0,0,"0,00%","100,00%",16
ext_matvalle,15,0,0,0,"0,00%","100,00%",16
ext_aiolmedo,15,0,0,0,"0,00%","100,00%",16
ext_ola,12,0,0,0,"0,00%","100,00%",16
ext_namangas,12,2,0,2,"16,67%","83,33%",16
ext_sancjoaq,11,7,0,7,"63,64%","30,77%",16
ext_facacuna,145,18,13,5,"12,41%","88,89%",17
ext_toarruss,94,6,6,0,"6,38%","93,62%",17
ext_masolvey,92,1,0,1,"1,09%","98,91%",17
ext_fltangor,77,12,3,9,"15,58%","84,42%",17
ext_juawagne,73,29,22,7,"39,73%","53,57%",17
ext_jocambar,70,3,1,2,"4,29%","95,77%",17
ext_nadsosa,66,2,1,1,"3,03%","96,97%",17
ext_tovulcan,62,4,0,4,"6,45%","93,55%",17
ext_fagaglia,62,0,0,0,"0,00%","100,00%",17
ext_joavgust,43,2,2,0,"4,65%","95,45%",17
ext_ola,41,9,3,6,"21,95%","78,57%",17
ext_kevvigil,32,0,0,0,"0,00%","100,00%",17
ext_matvalle,32,4,3,1,"12,50%","87,50%",17
ext_matiam,26,3,1,2,"11,54%","88,46%",17
ext_enheredi,24,0,0,0,"0,00%","100,00%",17
ext_ramiherr,24,0,0,0,"0,00%","100,00%",17
ext_sancjoaq,18,1,0,1,"5,56%","94,44%",17
ext_mibrizue,17,3,0,3,"17,65%","82,35%",17
ext_igjerez,14,0,0,0,"0,00%","100,00%",17
ext_agnovare,14,0,0,0,"0,00%","100,00%",17
ext_joastori,11,3,0,3,"27,27%","72,73%",17
ext_jotrimar,6,1,0,1,"16,67%","83,33%",17
ext_namangas,4,0,0,0,"0,00%","100,00%",17
ext_aiolmedo,3,0,0,0,"0,00%","100,00%",17
ext_jodragon,1,0,0,0,"0,00%","100,00%",17
ext_enheredi,192,29,6,23,"15,10%","84,90%",18
ext_tovulcan,100,11,7,4,"11,00%","86,41%",18
ext_toarruss,91,5,2,3,"5,49%","94,51%",18
ext_sancjoaq,80,8,2,6,"10,00%","90,36%",18
ext_facacuna,70,15,3,12,"21,43%","77,46%",18
ext_tibareir,51,8,5,3,"15,69%","85,96%",18
ext_ensole,43,24,12,12,"55,81%","48,98%",18
ext_joastori,43,0,0,0,"0,00%","100,00%",18
ext_igcuevas,42,10,1,9,"23,81%","78,72%",18
ext_jocambar,40,11,2,9,"27,50%","72,50%",18
ext_matiam,39,0,0,0,"0,00%","100,00%",18
ext_masolvey,34,0,0,0,"0,00%","100,00%",18
ext_agnovare,30,0,0,0,"0,00%","100,00%",18
ext_juawagne,28,3,1,2,"10,71%","83,33%",18
ext_aiolmedo,23,0,0,0,"0,00%","100,00%",18
ext_mibrizue,23,1,0,1,"4,35%","95,65%",18
ext_fagaglia,19,6,0,6,"31,58%","68,42%",18
ext_ola,19,0,0,0,"0,00%","100,00%",18
ext_kevvigil,19,8,0,8,"42,11%","57,89%",18
ext_namangas,17,0,0,0,"0,00%","100,00%",18
ext_matvalle,15,7,0,7,"46,67%","53,33%",18
ext_joavgust,13,2,0,2,"15,38%","84,62%",18
ext_ramiherr,11,3,0,3,"27,27%","72,73%",18
ext_fltangor,5,2,0,2,"40,00%","60,00%",18
ext_nadsosa,5,0,0,0,"0,00%","100,00%",18
ext_jodragon,2,0,0,0,"0,00%","100,00%",18
ext_fltangor,157,41,20,21,"26,11%","73,89%",19
ext_juawagne,156,2,1,1,"1,28%","99,02%",19
ext_igcuevas,143,19,5,14,"13,29%","86,71%",19
ext_nadsosa,104,0,0,0,"0,00%","100,00%",19
ext_jocambar,87,7,4,3,"8,05%","91,95%",19
ext_tovulcan,76,5,2,3,"6,58%","92,41%",19
ext_tibareir,65,2,0,2,"3,08%","97,26%",19
ext_ensole,62,4,3,1,"6,45%","93,85%",19
ext_matvalle,47,22,22,0,"46,81%","53,19%",19
ext_joastori,32,1,1,0,"3,13%","97,06%",19
ext_aiolmedo,31,0,0,0,"0,00%","100,00%",19
ext_agnovare,23,0,0,0,"0,00%","100,00%",19
ext_facacuna,22,0,0,0,"0,00%","100,00%",19
ext_jotrimar,20,3,0,3,"15,00%","85,00%",19
ext_enheredi,18,3,0,3,"16,67%","83,33%",19
ext_joavgust,9,0,0,0,"0,00%","100,00%",19
ext_igjerez,7,0,0,0,"0,00%","100,00%",19
ext_matiam,7,0,0,0,"0,00%","100,00%",19
ext_masolvey,7,2,2,0,"28,57%","66,67%",19
ext_mibrizue,7,0,0,0,"0,00%","100,00%",19
ext_kevvigil,7,2,1,1,"28,57%","71,43%",19
ext_sancjoaq,5,0,0,0,"0,00%","100,00%",19
ext_namangas,5,0,0,0,"0,00%","100,00%",19
ext_toarruss,1,0,0,0,"0,00%","100,00%",19
ext_tovulcan,168,10,8,2,"5,95%","94,74%",20
ext_facacuna,111,31,11,20,"27,93%","75,19%",20
ext_joastori,89,1,0,1,"1,12%","98,88%",20
ext_juawagne,82,16,14,2,"19,51%","81,18%",20
ext_matvalle,78,0,0,0,"0,00%","100,00%",20
ext_igcuevas,77,23,17,6,"29,87%","74,16%",20
ext_joavgust,74,2,0,2,"2,70%","97,37%",20
ext_mibrizue,74,21,18,3,"28,38%","71,62%",20
ext_toarruss,70,0,0,0,"0,00%","100,00%",20
ext_ensole,66,11,10,1,"16,67%","77,22%",20
ext_sancjoaq,61,7,7,0,"11,48%","88,52%",20
ext_fltangor,59,31,14,17,"52,54%","47,46%",20
ext_namangas,57,8,0,8,"14,04%","86,67%",20
ext_agnovare,56,16,8,8,"28,57%","71,43%",20
ext_ola,55,8,2,6,"14,55%","85,45%",20
ext_nadsosa,38,14,14,0,"36,84%","63,16%",20
ext_enheredi,37,0,0,0,"0,00%","100,00%",20
ext_jocambar,27,0,0,0,"0,00%","100,00%",20
ext_igjerez,25,0,0,0,"0,00%","100,00%",20
ext_aiolmedo,20,0,0,0,"0,00%","100,00%",20
ext_masolvey,19,0,0,0,"0,00%","100,00%",20
ext_jodragon,17,0,0,0,"0,00%","100,00%",20
ext_matiam,16,1,0,1,"6,25%","94,74%",20
ext_kevvigil,13,1,0,1,"7,69%","87,50%",20
ext_fagaglia,12,2,0,2,"16,67%","83,33%",20
ext_jotrimar,9,1,0,1,"11,11%","88,89%",20
ext_ramiherr,6,0,0,0,"0,00%","100,00%",20
ext_ensole,126,12,4,8,"9,52%","90,48%",21
ext_tibareir,107,5,2,3,"4,67%","95,33%",21
ext_juawagne,101,21,5,16,"20,79%","76,92%",21
ext_kevvigil,99,11,2,9,"11,11%","88,24%",21
ext_facacuna,91,33,20,13,"36,26%","64,89%",21
ext_mibrizue,90,7,4,3,"7,78%","92,47%",21
ext_matiam,88,9,5,4,"10,23%","89,77%",21
ext_toarruss,85,17,10,7,"20,00%","80,00%",21
ext_jotrimar,84,2,0,2,"2,38%","97,65%",21
ext_masolvey,81,2,0,2,"2,47%","97,62%",21
ext_enheredi,77,2,2,0,"2,60%","97,40%",21
ext_agnovare,72,0,0,0,"0,00%","100,00%",21
ext_sancjoaq,67,3,2,1,"4,48%","95,59%",21
ext_fltangor,67,25,17,8,"37,31%","62,69%",21
ext_matvalle,65,3,0,3,"4,62%","95,38%",21
ext_tovulcan,56,14,12,2,"25,00%","74,19%",21
ext_joastori,55,6,1,5,"10,91%","89,09%",21
ext_jocambar,53,18,1,17,"33,96%","66,04%",21
ext_namangas,40,0,0,0,"0,00%","100,00%",21
ext_igcuevas,33,16,8,8,"48,48%","51,52%",21
ext_igjerez,21,2,1,1,"9,52%","90,48%",21
ext_aiolmedo,19,0,0,0,"0,00%","100,00%",21
ext_joavgust,11,0,0,0,"0,00%","100,00%",21
ext_nadsosa,8,4,2,2,"50,00%","50,00%",21
ext_fagaglia,7,2,0,2,"28,57%","71,43%",21
ext_ramiherr,4,2,1,1,"50,00%","50,00%",21
ext_ola,3,1,0,1,"33,33%","66,67%",21
ext_jodragon,2,0,0,0,"0,00%","100,00%",21
ext_sancjoaq,146,7,5,2,"4,79%","95,42%",22
ext_juawagne,138,21,15,6,"15,22%","84,17%",22
ext_kevvigil,125,17,12,5,"13,60%","85,38%",22
ext_toarruss,111,6,1,5,"5,41%","94,59%",22
ext_joastori,106,38,29,9,"35,85%","64,66%",22
ext_dadi,101,6,2,4,"5,94%","94,12%",22
ext_facacuna,98,11,4,7,"11,22%","88,78%",22
ext_jocambar,97,2,0,2,"2,06%","98,06%",22
ext_matiam,90,1,0,1,"1,11%","98,89%",22
ext_joavgust,85,24,3,21,"28,24%","78,95%",22
ext_tibareir,67,4,1,3,"5,97%","94,12%",22
ext_igjerez,56,1,1,0,"1,79%","98,21%",22
ext_namangas,53,2,1,1,"3,77%","96,49%",22
ext_aiolmedo,48,0,0,0,"0,00%","100,00%",22
ext_igcuevas,48,7,3,4,"14,58%","81,13%",22
ext_fltangor,43,4,2,2,"9,30%","90,91%",22
ext_jotrimar,41,0,0,0,"0,00%","100,00%",22
ext_tovulcan,40,9,4,5,"22,50%","79,07%",22
ext_mibrizue,32,3,2,1,"9,38%","88,24%",22
ext_agnovare,26,11,0,11,"42,31%","45,95%",22
ext_ensole,26,1,1,0,"3,85%","96,15%",22
ext_matvalle,19,0,0,0,"0,00%","100,00%",22
ext_nadsosa,10,0,0,0,"0,00%","100,00%",22
ext_masolvey,9,2,0,2,"22,22%","77,78%",22
ext_mibrizue,41,4,0,4,"9,76%","90,24%",23
ext_fagaglia,40,5,2,3,"12,50%","87,50%",23
ext_agnovare,39,3,3,0,"7,69%","92,31%",23
ext_juawagne,38,1,1,0,"2,63%","97,37%",23
ext_masolvey,38,0,0,0,"0,00%","100,00%",23
ext_joavgust,38,5,3,2,"13,16%","88,37%",23
ext_sancjoaq,38,5,0,5,"13,16%","86,84%",23
ext_jotrimar,38,2,1,1,"5,26%","94,74%",23
ext_ramiherr,38,1,0,1,"2,63%","97,37%",23
ext_igjerez,37,0,0,0,"0,00%","100,00%",23
ext_ensole,37,4,1,3,"10,81%","90,24%",23
ext_toarruss,37,2,2,0,"5,41%","94,59%",23
ext_facacuna,37,1,0,1,"2,70%","97,30%",23
ext_kevvigil,37,3,1,2,"8,11%","92,50%",23
ext_matiam,37,3,1,2,"8,11%","92,31%",23
ext_nadsosa,36,3,0,3,"8,33%","91,67%",23
ext_tovulcan,36,2,0,2,"5,56%","95,35%",23
ext_dadi,35,5,2,3,"14,29%","82,05%",23
ext_igcuevas,34,3,1,2,"8,82%","91,18%",23
ext_fltangor,33,4,1,3,"12,12%","88,24%",23
ext_namangas,31,9,1,8,"29,03%","70,97%",23
ext_jocambar,31,2,1,1,"6,45%","93,55%",23
ext_joastori,30,0,0,0,"0,00%","100,00%",23
ext_tibareir,29,2,0,2,"6,90%","93,10%",23
ext_aiolmedo,29,0,0,0,"0,00%","100,00%",23
ext_ola,28,2,1,1,"7,14%","92,86%",23
ext_matvalle,28,3,2,1,"10,71%","89,29%",23
ext_fagaglia,82,17,4,13,"20,73%","79,27%",24
ext_igcuevas,80,0,0,0,"0,00%","100,00%",24
ext_facacuna,80,10,0,10,"12,50%","87,50%",24
ext_fltangor,80,18,8,10,"22,50%","77,50%",24
ext_ramiherr,80,4,3,1,"5,00%","95,00%",24
ext_jocambar,51,0,0,0,"0,00%","100,00%",24
ext_toarruss,50,1,0,1,"2,00%","96,08%",24
ext_joastori,50,0,0,0,"0,00%","100,00%",24
ext_nadsosa,50,1,0,1,"2,00%","98,00%",24
ext_sancjoaq,50,18,4,14,"36,00%","64,00%",24
ext_dadi,50,12,0,12,"24,00%","76,00%",24
ext_kevvigil,50,25,3,22,"50,00%","50,00%",24
ext_igjerez,50,2,2,0,"4,00%","96,00%",24
ext_ola,50,1,0,1,"2,00%","96,67%",24
ext_masolvey,50,0,0,0,"0,00%","100,00%",24
ext_jotrimar,50,1,0,1,"2,00%","98,00%",24
ext_matiam,50,4,1,3,"8,00%","92,00%",24
ext_mibrizue,50,0,0,0,"0,00%","100,00%",24
ext_juawagne,50,2,2,0,"4,00%","96,00%",24
ext_jodragon,50,0,0,0,"0,00%","100,00%",24
ext_agnovare,50,0,0,0,"0,00%","100,00%",24
ext_tovulcan,50,3,0,3,"6,00%","94,00%",24
ext_namangas,50,9,8,1,"18,00%","82,00%",24
ext_ensole,50,0,0,0,"0,00%","100,00%",24
ext_matvalle,50,0,0,0,"0,00%","100,00%",24
ext_joavgust,49,0,0,0,"0,00%","100,00%",24
ext_kevvigil,54,0,0,0,"0,00%","100,00%",25
ext_fltangor,54,0,0,0,"0,00%","100,00%",25
ext_namangas,54,0,0,0,"0,00%","100,00%",25
ext_sancjoaq,54,2,0,2,"3,70%","96,30%",25
ext_fagaglia,54,0,0,0,"0,00%","100,00%",25
ext_matiam,38,0,0,0,"0,00%","100,00%",25
ext_toarruss,38,0,0,0,"0,00%","100,00%",25
ext_agnovare,38,0,0,0,"0,00%","100,00%",25
ext_ensole,38,0,0,0,"0,00%","100,00%",25
ext_mibrizue,38,24,1,23,"63,16%","36,84%",25
ext_jocambar,38,0,0,0,"0,00%","100,00%",25
ext_dadi,38,0,0,0,"0,00%","100,00%",25
ext_joastori,38,8,0,8,"21,05%","78,95%",25
ext_facacuna,38,4,0,4,"10,53%","89,47%",25
ext_ramiherr,38,8,2,6,"21,05%","78,95%",25
ext_joavgust,38,1,0,1,"2,63%","94,87%",25
ext_nadsosa,38,0,0,0,"0,00%","100,00%",25
ext_igcuevas,38,3,0,3,"7,89%","92,11%",25
ext_ola,38,7,7,0,"18,42%","81,58%",25
ext_jodragon,38,0,0,0,"0,00%","100,00%",25
ext_matvalle,38,0,0,0,"0,00%","100,00%",25
ext_tovulcan,38,1,1,0,"2,63%","97,37%",25
ext_juawagne,38,24,3,21,"63,16%","36,84%",25
ext_masolvey,38,2,1,1,"5,26%","94,74%",25
ext_igjerez,38,0,0,0,"0,00%","100,00%",25
ext_jotrimar,38,0,0,0,"0,00%","100,00%",25
ext_masolvey,24,0,0,0,"0,00%","100,00%",26
ext_aiolmedo,23,0,0,0,"0,00%","100,00%",26
ext_ola,23,0,0,0,"0,00%","100,00%",26
ext_fltangor,23,0,0,0,"0,00%","100,00%",26
ext_joavgust,23,1,0,1,"4,35%","95,65%",26
ext_matvalle,23,0,0,0,"0,00%","100,00%",26
ext_ensole,23,0,0,0,"0,00%","100,00%",26
ext_sancjoaq,23,5,0,5,"21,74%","79,17%",26
ext_jodragon,23,3,3,0,"13,04%","86,96%",26
ext_nadsosa,23,8,2,6,"34,78%","65,22%",26
ext_tovulcan,23,0,0,0,"0,00%","100,00%",26
ext_igjerez,23,0,0,0,"0,00%","100,00%",26
ext_juawagne,23,0,0,0,"0,00%","100,00%",26
ext_fagaglia,23,0,0,0,"0,00%","100,00%",26
ext_ramiherr,23,0,0,0,"0,00%","100,00%",26
ext_mibrizue,23,0,0,0,"0,00%","100,00%",26
ext_tibareir,23,0,0,0,"0,00%","100,00%",26
ext_jotrimar,23,0,0,0,"0,00%","100,00%",26
ext_matiam,23,0,0,0,"0,00%","100,00%",26
ext_agnovare,23,0,0,0,"0,00%","100,00%",26
ext_facacuna,23,0,0,0,"0,00%","100,00%",26
ext_igcuevas,23,3,0,3,"13,04%","86,96%",26
ext_kevvigil,23,0,0,0,"0,00%","100,00%",26
ext_dadi,23,2,0,2,"8,70%","91,30%",26
ext_toarruss,23,0,0,0,"0,00%","100,00%",26
ext_joastori,23,0,0,0,"0,00%","100,00%",26
ext_jocambar,23,1,0,1,"4,35%","95,65%",26
ext_namangas,23,0,0,0,"0,00%","100,00%",26
ext_juawagne,60,3,0,3,"5,00%","95,00%",27
ext_mibrizue,60,11,0,11,"18,33%","81,67%",27
ext_matiam,40,0,0,0,"0,00%","100,00%",27
ext_sancjoaq,40,3,0,3,"7,50%","92,50%",27
ext_masolvey,40,1,0,1,"2,50%","97,50%",27
ext_facacuna,40,8,0,8,"20,00%","80,00%",27
ext_matvalle,40,0,0,0,"0,00%","100,00%",27
ext_fltangor,40,12,0,12,"30,00%","70,00%",27
ext_igjerez,40,0,0,0,"0,00%","100,00%",27
ext_joastori,40,0,0,0,"0,00%","100,00%",27
ext_tibareir,40,1,0,1,"2,50%","97,50%",27
ext_jodragon,40,0,0,0,"0,00%","100,00%",27
ext_namangas,40,0,0,0,"0,00%","100,00%",27
ext_nadsosa,40,1,1,0,"2,50%","97,50%",27
ext_ensole,40,0,0,0,"0,00%","100,00%",27
ext_tovulcan,40,0,0,0,"0,00%","100,00%",27
ext_kevvigil,40,0,0,0,"0,00%","100,00%",27
ext_jotrimar,40,0,0,0,"0,00%","100,00%",27
ext_toarruss,40,1,0,1,"2,50%","97,50%",27
ext_agnovare,40,0,0,0,"0,00%","100,00%",27
ext_igcuevas,40,0,0,0,"0,00%","100,00%",27
ext_dadi,40,7,1,6,"17,50%","82,50%",27
ext_jocambar,40,8,4,4,"20,00%","80,49%",27
ext_ramiherr,40,0,0,0,"0,00%","100,00%",27
ext_ola,40,3,0,3,"7,50%","92,50%",27
ext_fagaglia,40,0,0,0,"0,00%","100,00%",27
ext_joavgust,40,11,9,2,"27,50%","77,08%",27
ext_fltangor,58,0,0,0,"0,00%","100,00%",28
ext_joavgust,58,0,0,0,"0,00%","100,00%",28
ext_facacuna,58,9,8,1,"15,52%","86,76%",28
ext_jocambar,52,8,1,7,"15,38%","84,62%",28
ext_toarruss,40,0,0,0,"0,00%","100,00%",28
ext_masolvey,40,4,0,4,"10,00%","90,24%",28
ext_elgramug,40,0,0,0,"0,00%","100,00%",28
ext_jotrimar,40,0,0,0,"0,00%","100,00%",28
ext_igcuevas,40,1,0,1,"2,50%","97,50%",28
ext_francof,40,8,1,7,"20,00%","80,00%",28
ext_dadi,40,0,0,0,"0,00%","100,00%",28
ext_juawagne,40,1,0,1,"2,50%","97,50%",28
ext_igjerez,40,0,0,0,"0,00%","100,00%",28
ext_tibareir,38,0,0,0,"0,00%","100,00%",28
ext_matvalle,38,0,0,0,"0,00%","100,00%",28
ext_joastori,38,0,0,0,"0,00%","100,00%",28
ext_nadsosa,38,6,0,6,"15,79%","84,21%",28
ext_namangas,33,1,1,0,"3,03%","96,97%",28
ext_ensole,32,1,1,0,"3,13%","96,88%",28
ext_fagaglia,32,3,0,3,"9,38%","90,63%",28
ext_kevvigil,32,3,3,0,"9,38%","90,63%",28
ext_matiam,32,11,0,11,"34,38%","65,63%",28
ext_jodragon,32,0,0,0,"0,00%","100,00%",28
ext_ola,32,0,0,0,"0,00%","100,00%",28
ext_sancjoaq,32,8,0,8,"25,00%","81,40%",28
ext_tovulcan,32,3,2,1,"9,38%","95,45%",28
ext_ramiherr,32,13,0,13,"40,63%","59,38%",28
ext_agnovare,32,1,1,0,"3,13%","96,88%",28
ext_francof,50,3,0,3,"6,00%","94,00%",29
ext_sancjoaq,50,6,1,5,"12,00%","88,00%",29
ext_ramiherr,50,1,1,0,"2,00%","98,00%",29
ext_matiam,50,0,0,0,"0,00%","100,00%",29
ext_elgramug,40,0,0,0,"0,00%","100,00%",29
ext_toarruss,40,0,0,0,"0,00%","100,00%",29
ext_ola,40,12,0,12,"30,00%","71,11%",29
ext_jocambar,40,15,0,15,"37,50%","62,50%",29
ext_masolvey,40,9,0,9,"22,50%","77,50%",29
ext_nadsosa,40,4,1,3,"10,00%","90,00%",29
ext_tibareir,40,1,1,0,"2,50%","97,50%",29
ext_joavgust,40,0,0,0,"0,00%","100,00%",29
ext_jotrimar,40,0,0,0,"0,00%","100,00%",29
ext_aiolmedo,40,0,0,0,"0,00%","100,00%",29
ext_joastori,40,5,0,5,"12,50%","87,50%",29
ext_namangas,40,0,0,0,"0,00%","100,00%",29
ext_dadi,40,0,0,0,"0,00%","100,00%",29
ext_agnovare,40,1,0,1,"2,50%","97,50%",29
ext_igcuevas,40,0,0,0,"0,00%","100,00%",29
ext_fltangor,40,2,2,0,"5,00%","95,35%",29
ext_fagaglia,40,2,1,1,"5,00%","95,00%",29
ext_mibrizue,40,0,0,0,"0,00%","100,00%",29
ext_jodragon,40,0,0,0,"0,00%","100,00%",29
ext_igjerez,40,0,0,0,"0,00%","100,00%",29
ext_matvalle,40,0,0,0,"0,00%","100,00%",29
ext_tovulcan,40,0,0,0,"0,00%","100,00%",29
ext_facacuna,40,1,0,1,"2,50%","97,50%",29
ext_ensole,40,25,14,11,"62,50%","37,50%",29
ext_juawagne,40,0,0,0,"0,00%","100,00%",29
ext_jocambar,60,2,1,1,"3,33%","96,67%",30
ext_ensole,60,2,0,2,"3,33%","96,67%",30
ext_namangas,40,1,0,1,"2,50%","97,50%",30
ext_facacuna,40,3,3,0,"7,50%","92,50%",30
ext_joastori,40,4,3,1,"10,00%","90,00%",30
ext_nadsosa,40,18,2,16,"45,00%","43,14%",30
ext_ola,40,4,0,4,"10,00%","90,24%",30
ext_fltangor,40,5,0,5,"12,50%","87,50%",30
ext_igcuevas,40,0,0,0,"0,00%","100,00%",30
ext_igjerez,40,0,0,0,"0,00%","100,00%",30
ext_tibareir,40,5,5,0,"12,50%","89,36%",30
ext_jodragon,40,1,0,1,"2,50%","97,73%",30
ext_matvalle,40,0,0,0,"0,00%","100,00%",30
ext_sancjoaq,40,0,0,0,"0,00%","100,00%",30
ext_ramiherr,40,0,0,0,"0,00%","100,00%",30
ext_fagaglia,40,3,1,2,"7,50%","92,50%",30
ext_francof,40,8,0,8,"20,00%","83,93%",30
ext_elgramug,40,0,0,0,"0,00%","100,00%",30
ext_dadi,40,0,0,0,"0,00%","100,00%",30
ext_masolvey,40,0,0,0,"0,00%","100,00%",30
ext_toarruss,40,11,0,11,"27,50%","72,50%",30
ext_juawagne,40,7,7,0,"17,50%","82,50%",30
ext_aiolmedo,40,0,0,0,"0,00%","100,00%",30
ext_jotrimar,40,0,0,0,"0,00%","100,00%",30
ext_joavgust,40,0,0,0,"0,00%","100,00%",30
ext_mibrizue,40,2,1,1,"5,00%","95,00%",30
ext_tovulcan,40,0,0,0,"0,00%","100,00%",30
ext_agnovare,40,0,0,0,"0,00%","100,00%",30
ext_matiam,40,0,0,0,"0,00%","100,00%",30
ext_igcuevas,80,5,3,2,"6,25%","93,75%",31
ext_toarruss,80,9,7,2,"11,25%","88,75%",31
ext_fltangor,80,1,0,1,"1,25%","98,75%",31
ext_dadi,40,7,1,6,"17,50%","82,50%",31
ext_facacuna,40,4,3,1,"10,00%","90,00%",31
ext_igjerez,40,2,0,2,"5,00%","95,00%",31
ext_jodragon,40,1,0,1,"2,50%","97,50%",31
ext_ramiherr,40,3,0,3,"7,50%","92,50%",31
ext_jocambar,40,5,1,4,"12,50%","89,06%",31
ext_francof,40,0,0,0,"0,00%","100,00%",31
ext_fagaglia,40,1,0,1,"2,50%","97,73%",31
ext_sancjoaq,40,12,3,9,"30,00%","70,00%",31
ext_agnovare,40,0,0,0,"0,00%","100,00%",31
ext_tovulcan,40,1,0,1,"2,50%","97,50%",31
ext_aiolmedo,40,0,0,0,"0,00%","100,00%",31
ext_matvalle,40,0,0,0,"0,00%","100,00%",31
ext_joastori,40,5,0,5,"12,50%","87,50%",31
ext_ensole,40,0,0,0,"0,00%","100,00%",31
ext_ola,40,13,0,13,"32,50%","67,50%",31
ext_mibrizue,40,1,0,1,"2,50%","97,50%",31
ext_tibareir,40,3,0,3,"7,50%","93,02%",31
ext_namangas,40,2,2,0,"5,00%","95,00%",31
ext_juawagne,40,0,0,0,"0,00%","100,00%",31
ext_joavgust,40,3,0,3,"7,50%","92,50%",31
ext_elgramug,40,3,0,3,"7,50%","92,50%",31
ext_nadsosa,40,0,0,0,"0,00%","100,00%",31
ext_ola,60,31,9,22,"51,67%","48,33%",32
ext_joastori,60,0,0,0,"0,00%","100,00%",32
ext_dadi,60,5,1,4,"8,33%","91,67%",32
ext_sancjoaq,52,3,0,3,"5,77%","94,55%",32
ext_ramiherr,48,6,0,6,"12,50%","87,50%",32
ext_nadsosa,43,0,0,0,"0,00%","100,00%",32
ext_joavgust,42,0,0,0,"0,00%","100,00%",32
ext_tibareir,41,6,0,6,"14,63%","85,37%",32
ext_fltangor,41,0,0,0,"0,00%","100,00%",32
ext_matiam,40,3,3,0,"7,50%","92,50%",32
ext_mibrizue,40,0,0,0,"0,00%","100,00%",32
ext_agnovare,40,3,3,0,"7,50%","92,68%",32
ext_francof,40,2,0,2,"5,00%","95,00%",32
ext_ensole,40,1,0,1,"2,50%","97,50%",32
ext_jotrimar,40,2,1,1,"5,00%","95,00%",32
ext_jodragon,40,0,0,0,"0,00%","100,00%",32
ext_fagaglia,40,3,0,3,"7,50%","92,50%",32
ext_toarruss,40,6,0,6,"15,00%","85,00%",32
ext_namangas,40,6,0,6,"15,00%","85,00%",32
ext_facacuna,40,0,0,0,"0,00%","100,00%",32
ext_juawagne,40,7,3,4,"17,50%","82,50%",32
ext_elgramug,40,4,0,4,"10,00%","90,00%",32
ext_jocambar,40,6,1,5,"15,00%","85,00%",32
ext_matvalle,40,4,3,1,"10,00%","90,24%",32
ext_igcuevas,40,13,0,13,"32,50%","67,50%",32
ext_aiolmedo,40,0,0,0,"0,00%","100,00%",32
ext_tovulcan,40,7,5,2,"17,50%","82,50%",32
ext_tovulcan,52,4,0,4,"7,69%","92,31%",33
ext_ola,50,14,3,11,"28,00%","73,58%",33
ext_juawagne,50,2,2,0,"4,00%","96,00%",33
ext_igcuevas,50,0,0,0,"0,00%","100,00%",33
ext_dadi,44,1,0,1,"2,27%","97,73%",33
ext_jodragon,41,0,0,0,"0,00%","100,00%",33
ext_ramiherr,41,0,0,0,"0,00%","100,00%",33
ext_jocambar,41,0,0,0,"0,00%","100,00%",33
ext_namangas,41,0,0,0,"0,00%","100,00%",33
ext_sancjoaq,41,0,0,0,"0,00%","100,00%",33
ext_facacuna,40,2,1,1,"5,00%","95,00%",33
ext_mibrizue,40,3,1,2,"7,50%","92,50%",33
ext_aiolmedo,40,0,0,0,"0,00%","100,00%",33
ext_igjerez,40,3,2,1,"7,50%","92,50%",33
ext_elgramug,40,1,0,1,"2,50%","97,50%",33
ext_tibareir,40,0,0,0,"0,00%","100,00%",33
ext_matiam,40,1,0,1,"2,50%","97,62%",33
ext_ensole,40,5,0,5,"12,50%","91,07%",33
ext_nadsosa,40,1,0,1,"2,50%","97,50%",33
ext_fagaglia,40,11,2,9,"27,50%","72,50%",33
ext_francof,40,0,0,0,"0,00%","100,00%",33
ext_joastori,40,1,1,0,"2,50%","97,50%",33
ext_joavgust,40,14,13,1,"35,00%","65,00%",33
ext_jotrimar,40,0,0,0,"0,00%","100,00%",33
ext_matvalle,40,13,3,10,"32,50%","67,50%",33
ext_agnovare,40,0,0,0,"0,00%","100,00%",33
ext_fltangor,40,6,3,3,"15,00%","85,00%",33
ext_toarruss,36,0,0,0,"0,00%","100,00%",33
ext_fltangor,50,14,10,4,"28,00%","73,08%",34
ext_ola,50,0,0,0,"0,00%","100,00%",34
ext_fagaglia,47,16,8,8,"34,04%","65,96%",34
ext_joavgust,47,24,12,12,"51,06%","48,94%",34
ext_matvalle,47,1,0,1,"2,13%","97,87%",34
ext_jocambar,40,4,4,0,"10,00%","90,00%",34
ext_matiam,40,0,0,0,"0,00%","100,00%",34
ext_joastori,40,5,5,0,"12,50%","87,50%",34
ext_toarruss,40,1,1,0,"2,50%","97,78%",34
ext_tovulcan,40,1,0,1,"2,50%","97,50%",34
ext_ramiherr,40,1,0,1,"2,50%","97,50%",34
ext_namangas,40,3,1,2,"7,50%","92,50%",34
ext_nadsosa,40,1,0,1,"2,50%","97,50%",34
ext_jodragon,40,0,0,0,"0,00%","100,00%",34
ext_igjerez,40,1,1,0,"2,50%","97,50%",34
ext_agnovare,40,2,0,2,"5,00%","95,00%",34
ext_tibareir,40,1,1,0,"2,50%","97,50%",34
ext_jotrimar,40,0,0,0,"0,00%","100,00%",34
ext_ensole,40,8,6,2,"20,00%","80,00%",34
ext_mibrizue,40,3,0,3,"7,50%","90,48%",34
ext_igcuevas,40,1,1,0,"2,50%","97,50%",34
ext_francof,40,1,0,1,"2,50%","97,50%",34
ext_aiolmedo,40,0,0,0,"0,00%","100,00%",34
ext_facacuna,40,13,2,11,"32,50%","65,85%",34
ext_sancjoaq,40,6,5,1,"15,00%","85,00%",34
ext_juawagne,40,0,0,0,"0,00%","100,00%",34
ext_elgramug,40,0,0,0,"0,00%","100,00%",34
ext_dadi,39,1,0,1,"2,56%","97,44%",34
ext_joavgust,50,9,0,9,"0,18","82,00%",35
ext_fltangor,45,3,1,2,"0,06666666667","93,75%",35
ext_facacuna,45,10,1,9,"0,2222222222","77,78%",35
ext_francof,40,6,0,6,"0,15","85,00%",35
ext_dadi,30,2,0,2,"0,06666666667","93,33%",35
ext_sancjoaq,30,0,0,0,0,"100,00%",35
ext_ola,30,0,0,0,0,"100,00%",35
ext_nadsosa,30,0,0,0,0,"100,00%",35
ext_agnovare,30,0,0,0,0,"100,00%",35
ext_aiolmedo,30,0,0,0,0,"100,00%",35
ext_matiam,30,1,0,1,"0,03333333333","96,67%",35
ext_jodragon,30,0,0,0,0,"100,00%",35
ext_ramiherr,30,7,0,7,"0,2333333333","77,42%",35
ext_ensole,30,0,0,0,0,"100,00%",35
ext_juawagne,30,0,0,0,0,"100,00%",35
ext_jotrimar,30,0,0,0,0,"100,00%",35
ext_joastori,30,2,0,2,"0,06666666667","93,33%",35
ext_tibareir,30,0,0,0,0,"100,00%",35
ext_matvalle,30,0,0,0,0,"100,00%",35
ext_toarruss,30,0,0,0,0,"100,00%",35
ext_mibrizue,30,0,0,0,0,"100,00%",35
ext_igjerez,30,1,1,0,"0,03333333333","96,88%",35
ext_jocambar,30,8,4,4,"0,2666666667","73,33%",35
ext_namangas,30,0,0,0,0,"100,00%",35
ext_elgramug,30,0,0,0,0,"100,00%",35
ext_igcuevas,30,9,8,1,"0,3","70,00%",35
ext_tovulcan,29,2,0,2,"0,06896551724","93,10%",35
ext_igcuevas,60,7,1,6,"0,1166666667","88,33%",36
ext_jocambar,60,0,0,0,0,"100,00%",36
ext_facacuna,50,0,0,0,0,"100,00%",36
ext_ramiherr,50,1,0,1,"0,02","98,00%",36
ext_francof,50,5,0,5,"0,1","90,00%",36
ext_fagaglia,30,1,0,1,"0,03333333333","96,67%",36
ext_elgramug,30,1,0,1,"0,03333333333","96,67%",36
ext_ola,30,8,7,1,"0,2666666667","73,33%",36
ext_igjerez,30,3,1,2,"0,1","90,63%",36
ext_matiam,30,1,0,1,"0,03333333333","96,67%",36
ext_jodragon,30,0,0,0,0,"100,00%",36
ext_juawagne,30,3,1,2,"0,1","90,00%",36
ext_nadsosa,30,10,2,8,"0,3333333333","66,67%",36
ext_fltangor,30,0,0,0,0,"100,00%",36
ext_matvalle,30,0,0,0,0,"100,00%",36
ext_toarruss,30,0,0,0,0,"100,00%",36
ext_jotrimar,30,0,0,0,0,"100,00%",36
ext_tovulcan,30,3,0,3,"0,1","90,00%",36
ext_dadi,30,0,0,0,0,"100,00%",36
ext_sancjoaq,30,5,1,4,"0,1666666667","88,64%",36
ext_namangas,30,1,0,1,"0,03333333333","94,59%",36
ext_joastori,30,2,0,2,"0,06666666667","93,33%",36
ext_ensole,30,0,0,0,0,"100,00%",36
ext_agnovare,30,1,1,0,"0,03333333333","96,67%",36
ext_mibrizue,30,0,0,0,0,"100,00%",36
ext_joavgust,67,4,4,0,"0,05970149254","94,03%",37
ext_ola,50,0,0,0,0,"100,00%",37
ext_matvalle,44,1,0,1,"0,02272727273","97,73%",37
ext_fltangor,44,0,0,0,0,"100,00%",37
ext_nadsosa,41,1,1,0,"0,0243902439","97,56%",37
ext_igcuevas,41,2,1,1,"0,0487804878","95,12%",37
ext_sancjoaq,41,17,17,0,"0,4146341463","63,27%",37
ext_jocambar,37,1,0,1,"0,02702702703","97,30%",37
ext_jodragon,35,2,2,0,"0,05714285714","94,29%",37
ext_toarruss,35,0,0,0,0,"100,00%",37
ext_namangas,35,5,0,5,"0,1428571429","85,71%",37
ext_igjerez,35,2,0,2,"0,05714285714","94,29%",37
ext_mibrizue,35,0,0,0,0,"100,00%",37
ext_ensole,35,5,5,0,"0,1428571429","85,71%",37
ext_matiam,35,0,0,0,0,"100,00%",37
ext_elgramug,35,1,0,1,"0,02857142857","97,14%",37
ext_francof,35,9,9,0,"0,2571428571","74,29%",37
ext_fagaglia,35,1,0,1,"0,02857142857","97,14%",37
ext_tovulcan,35,1,0,1,"0,02857142857","97,14%",37
ext_dadi,35,2,0,2,"0,05714285714","94,29%",37
ext_jotrimar,35,0,0,0,0,"100,00%",37
ext_agnovare,35,0,0,0,0,"100,00%",37
ext_joastori,35,6,0,6,"0,1714285714","82,86%",37
ext_facacuna,34,0,0,0,0,"100,00%",37
ext_juawagne,33,2,2,0,"0,06060606061","93,94%",37
ext_aiolmedo,12,0,0,0,0,"100,00%",37
ext_tibareir,11,1,1,0,"0,09090909091","90,91%",37
ext_sancjoaq,50,0,0,0,0,"100,00%",38
ext_igcuevas,42,6,0,6,"0,1428571429","88,00%",38
ext_fagaglia,42,8,0,8,"0,1904761905","80,95%",38
ext_fltangor,35,0,0,0,0,"100,00%",38
ext_ensole,35,0,0,0,0,"100,00%",38
ext_jocambar,35,7,0,7,"0,2","80,00%",38
ext_nadsosa,35,2,0,2,"0,05714285714","94,29%",38
ext_ola,35,2,0,2,"0,05714285714","94,87%",38
ext_facacuna,35,11,0,11,"0,3142857143","70,27%",38
ext_matvalle,35,2,0,2,"0,05714285714","94,29%",38
ext_elgramug,28,0,0,0,0,"100,00%",38
ext_francof,28,0,0,0,0,"100,00%",38
ext_namangas,28,0,0,0,0,"100,00%",38
ext_tovulcan,28,0,0,0,0,"100,00%",38
ext_jodragon,28,2,2,0,"0,07142857143","92,86%",38
ext_juawagne,28,3,3,0,"0,1071428571","89,29%",38
ext_joastori,28,0,0,0,0,"100,00%",38
ext_toarruss,28,0,0,0,0,"100,00%",38
ext_matiam,28,0,0,0,0,"100,00%",38
ext_joavgust,28,1,0,1,"0,03571428571","96,43%",38
ext_ramiherr,28,0,0,0,0,"100,00%",38
ext_jotrimar,28,4,0,4,"0,1428571429","85,71%",38
ext_dadi,28,0,0,0,0,"100,00%",38
ext_mibrizue,28,2,0,2,"0,07142857143","92,86%",38
ext_igjerez,28,0,0,0,0,"100,00%",38
ext_agnovare,28,1,0,1,"0,03571428571","96,43%",38
ext_fltangor,44,0,0,0,0,"100,00%",39
ext_jocambar,43,0,0,0,0,"100,00%",39
ext_nadsosa,35,2,1,1,"0,05714285714","94,29%",39
ext_francof,31,13,10,3,"0,4193548387","58,06%",39
ext_ensole,31,1,0,1,"0,03225806452","96,77%",39
ext_igcuevas,29,9,5,4,"0,3103448276","68,97%",39
ext_facacuna,26,4,1,3,"0,1538461538","86,21%",39
ext_joavgust,26,0,0,0,0,"100,00%",39
ext_namangas,26,0,0,0,0,"100,00%",39
ext_ramiherr,26,4,0,4,"0,1538461538","84,62%",39
ext_matiam,26,3,0,3,"0,1153846154","88,46%",39
ext_juawagne,26,0,0,0,0,"100,00%",39
ext_matvalle,26,0,0,0,0,"100,00%",39
ext_igjerez,26,1,0,1,"0,03846153846","96,15%",39
ext_ola,26,10,0,10,"0,3846153846","61,54%",39
ext_jodragon,26,0,0,0,0,"100,00%",39
ext_elgramug,26,0,0,0,0,"100,00%",39
ext_dadi,26,2,0,2,"0,07692307692","93,55%",39
ext_sancjoaq,26,2,0,2,"0,07692307692","94,59%",39
ext_agnovare,25,0,0,0,0,"100,00%",39
ext_mibrizue,25,0,0,0,0,"100,00%",39
ext_fagaglia,25,3,2,1,"0,12","88,00%",39
ext_tovulcan,25,0,0,0,0,"100,00%",39
ext_joastori,19,0,0,0,0,"100,00%",39
ext_aiolmedo,10,0,0,0,0,"100,00%",39
ext_jotrimar,6,0,0,0,0,"100,00%",39
ext_jocambar,37,8,0,8,"0,2162162162","80,00%",40
ext_fagaglia,37,0,0,0,0,"100,00%",40
ext_ola,37,1,1,0,"0,02702702703","97,30%",40
ext_nadsosa,37,0,0,0,0,"100,00%",40
ext_fltangor,37,0,0,0,0,"100,00%",40
ext_igcuevas,37,0,0,0,0,"100,00%",40
ext_facacuna,37,0,0,0,0,"100,00%",40
ext_francof,37,2,2,0,"0,05405405405","94,59%",40
ext_sancjoaq,37,1,0,1,"0,02702702703","97,30%",40
ext_siosanch,34,1,0,1,"0,02941176471","97,62%",40
ext_tovulcan,26,0,0,0,0,"100,00%",40
ext_ensole,26,0,0,0,0,"100,00%",40
ext_dadi,26,0,0,0,0,"100,00%",40
ext_joavgust,26,2,0,2,"0,07692307692","92,31%",40
ext_matiam,26,2,0,2,"0,07692307692","92,31%",40
ext_matvalle,26,4,3,1,"0,1538461538","78,79%",40
ext_juawagne,26,0,0,0,0,"100,00%",40
ext_toarruss,26,5,1,4,"0,1923076923","80,77%",40
ext_namangas,26,10,2,8,"0,3846153846","61,54%",40
ext_igjerez,26,0,0,0,0,"100,00%",40
ext_joastori,26,0,0,0,0,"100,00%",40
ext_elgramug,26,0,0,0,0,"100,00%",40
ext_ramiherr,26,1,0,1,"0,03846153846","96,15%",40
ext_mibrizue,26,1,0,1,"0,03846153846","96,15%",40
ext_jotrimar,26,0,0,0,0,"100,00%",40
ext_agnovare,25,1,0,1,"0,04","96,00%",40